,Date,Open,High,Low,Close,NH20,NH60,NH200,NH250,NL20,NL60,NL200,NL250,diffNHNL20d,RatioNHNL200d,Threshold_line,diffShortNHNL,diffLongNHNL,diffShortLongNHNL,diffShortLongNHNL_MA120,Advanced,Unchanged,Declined,Total,AD Line
0,2020-11-02,1196.6400146484375,1202.550048828125,1191.43994140625,1202.1600341796875,18,7,3,3,37,24,3,3,-2.7982326951399115,0.7309399207889921,0.8663004625349212,-17,0,-17,1.6083333333333334,256,214,175,645,-36.777594700084734
1,2020-11-03,1210.06005859375,1222.780029296875,1209.9000244140625,1221.3299560546875,33,14,4,4,9,5,1,1,3.5346097201767304,0.7282476130966843,0.8630661696273889,9,3,6,1.6,337,185,120,642,-35.69747125035009
2,2020-11-04,1223.6700439453125,1231.050048828125,1214.489990234375,1222.43994140625,28,12,5,5,12,5,1,1,2.3564064801178204,0.7254698353189065,0.8596466915346713,7,4,3,1.575,182,231,221,634,-36.10747545554299
3,2020-11-05,1234.6099853515625,1266.5799560546875,1232.719970703125,1264.3199462890625,49,17,8,8,8,4,1,1,6.0382916053019144,0.7236179834670547,0.8560574603555341,13,7,6,1.6083333333333334,382,161,98,641,-34.783433756897104
4,2020-11-06,1265.8399658203125,1270.219970703125,1251.0799560546875,1260.0799560546875,41,15,7,6,6,2,1,1,5.154639175257732,0.7245649531640245,0.8524419244625921,13,6,7,1.5666666666666667,164,201,280,645,-35.541231504150666
5,2020-11-09,1281.4100341796875,1293.9000244140625,1277.52001953125,1285.8800048828125,72,23,10,6,11,5,2,2,8.98379970544919,0.7238705087195799,0.8487106478289093,18,8,10,1.5333333333333334,317,186,140,643,-34.568336821170476
6,2020-11-10,1330.1400146484375,1346.719970703125,1313.0400390625,1341.239990234375,127,38,7,4,32,9,2,2,13.991163475699558,0.7201668050158763,0.8448620872446093,29,5,24,1.625,283,166,203,652,-33.87620828096449
7,2020-11-11,1353.6500244140625,1356.8299560546875,1331.3900146484375,1345.3399658203125,99,35,7,4,17,4,2,2,12.076583210603829,0.7164631013121725,0.8408900698701859,31,5,26,1.725,257,205,192,654,-33.31448416666769
8,2020-11-12,1340.4300537109375,1341.5699462890625,1327.1700439453125,1336.31005859375,46,21,8,6,11,7,5,4,5.154639175257732,0.7174602523093234,0.8370581284691716,14,3,11,1.65,198,203,243,644,-33.78415238498155
9,2020-11-13,1330.489990234375,1352.510009765625,1327.72998046875,1346.469970703125,61,24,7,5,10,5,0,0,7.511045655375552,0.7202380300871012,0.8332632241051946,19,7,12,1.5416666666666667,276,202,163,641,-33.03806241299063
10,2020-11-16,1360.93994140625,1365.8699951171875,1351.0400390625,1351.06005859375,112,59,18,13,13,8,1,1,14.580265095729013,0.7244890422328504,0.8296246400291165,51,17,34,1.6666666666666667,279,171,197,647,-32.34759576930209
11,2020-11-17,1356.4100341796875,1365.9100341796875,1344.550048828125,1349.81005859375,93,48,16,14,16,6,2,2,11.34020618556701,0.7317280994719074,0.826258222058538,42,14,28,1.5916666666666666,198,201,252,651,-32.864632259961375
12,2020-11-18,1345.760009765625,1364.6400146484375,1341.4599609375,1364.5899658203125,47,24,8,6,13,8,2,2,5.007363770250368,0.7395058772496853,0.8232066189027745,16,6,10,1.4,290,217,136,643,-32.024143105749005
13,2020-11-19,1363.5799560546875,1375.02001953125,1362.4100341796875,1369.4200439453125,102,54,17,14,4,2,0,0,14.43298969072165,0.743352031095839,0.8202832208752159,52,17,35,1.5916666666666666,287,213,149,649,-31.22111146684297
14,2020-11-20,1369.9599609375,1390.3699951171875,1368.199951171875,1389.3399658203125,142,68,16,11,2,1,0,0,20.61855670103093,0.743352031095839,0.8173598228476574,67,16,51,1.7666666666666666,331,203,115,649,-30.192119955987916
15,2020-11-23,1397.530029296875,1422.4300537109375,1395.5799560546875,1420.4300537109375,204,116,22,17,5,1,0,0,29.30780559646539,0.743352031095839,0.8144209927213334,115,22,93,2.075,353,183,118,654,-29.061998762025304
16,2020-11-24,1429.43994140625,1432.56005859375,1401.2900390625,1401.6300048828125,143,83,19,14,2,1,0,0,20.765832106038292,0.743352031095839,0.8114821625950095,82,19,63,2.2,161,179,316,656,-29.989959489163642
17,2020-11-25,1416.8399658203125,1428.3599853515625,1392.4200439453125,1415.719970703125,87,53,11,8,9,3,0,0,11.487481590574374,0.743352031095839,0.8085433324686856,50,11,39,2.1666666666666665,259,209,187,655,-29.40441944539452
18,2020-11-26,1420.9599609375,1433.5699462890625,1416.7900390625,1433.56005859375,96,69,23,17,5,1,0,0,13.402061855670103,0.743352031095839,0.8056045023423616,68,23,45,2.3833333333333333,310,207,130,647,-28.474158935975456
19,2020-11-27,1431.260009765625,1444.530029296875,1429.4300537109375,1437.780029296875,129,91,27,20,2,0,0,0,18.7039764359352,0.7470557347995429,0.8027891290061611,91,27,64,2.683333333333333,295,198,156,649,-27.638400321116144
20,2020-11-30,1429.989990234375,1435.0400390625,1408.02001953125,1408.31005859375,81,51,17,14,3,2,0,0,11.487481590574374,0.7520557347995428,0.8001404223366273,49,17,32,2.658333333333333,148,174,325,647,-28.644098372933176
21,2020-12-01,1418.06005859375,1430.030029296875,1416.3900146484375,1420.8699951171875,53,38,14,11,3,0,0,0,7.363770250368188,0.7557594385032466,0.7976151724572168,38,14,24,2.183333333333333,261,201,188,650,-28.042944367195993
22,2020-12-02,1416.5799560546875,1430.489990234375,1415.0999755859375,1417.949951171875,53,42,13,11,5,1,0,0,7.069219440353461,0.7578427718365799,0.795159367022251,41,13,28,1.6833333333333333,168,221,261,650,-28.69018382745697
23,2020-12-03,1424.1600341796875,1439.219970703125,1420.68994140625,1438.3199462890625,70,56,21,16,4,1,0,0,9.720176730486008,0.7611761051699132,0.7928146726983961,55,21,34,1.0583333333333333,323,210,114,647,-27.694934448148338
24,2020-12-04,1439.8199462890625,1454.93994140625,1439.1400146484375,1449.8299560546875,100,79,26,18,5,2,1,1,13.991163475699558,0.7679662286267034,0.7907066038889445,77,25,52,0.8666666666666667,253,215,180,648,-27.113588627691218
25,2020-12-08,1448.0799560546875,1484.72998046875,1442.6500244140625,1478.9200439453125,144,114,34,23,1,0,0,0,21.06038291605302,0.7707440064044812,0.7886911276720857,114,34,80,1.3833333333333333,325,178,150,653,-26.124824939399158
26,2020-12-09,1490.77001953125,1503.8900146484375,1474.8299560546875,1482.6700439453125,122,103,32,22,8,1,0,0,16.78939617083947,0.7749106730711478,0.7868145403441157,102,32,70,1.725,175,184,297,656,-26.93689603201326
27,2020-12-14,1491.8699951171875,1495.1800537109375,1471.56005859375,1476.1300048828125,102,85,35,26,26,5,1,1,11.192930780559646,0.7768286624891373,0.7849633057498316,80,34,46,1.9833333333333334,227,189,239,655,-27.188208376988275
28,2020-12-15,1468.219970703125,1478.6099853515625,1459.969970703125,1477.2099609375,85,69,36,31,16,2,0,0,10.1620029455081,0.7786805143409891,0.7831341170109268,67,36,31,2.05,249,215,192,656,-26.674507210074193
29,2020-12-16,1487.280029296875,1488.8599853515625,1475.0899658203125,1482.0899658203125,134,118,59,41,8,3,0,0,18.556701030927837,0.7870138476743224,0.7815364097535035,115,59,56,2.4166666666666665,330,184,142,656,-25.666431708826288
30,2020-12-17,1487.699951171875,1495.3699951171875,1483.3199462890625,1483.8900146484375,140,105,39,26,8,1,0,0,19.440353460972016,0.7929662286267034,0.7801093374167151,104,39,65,2.716666666666667,298,198,164,660,-24.845842387563298
31,2020-12-18,1485.27001953125,1489.780029296875,1475.010009765625,1482.3800048828125,99,87,35,27,3,0,0,0,14.138438880706921,0.7979662286267034,0.7788489317465934,87,35,52,2.95,209,175,270,654,-25.434562107880964
32,2020-12-21,1429.5,1453.8800048828125,1401.5799560546875,1401.780029296875,14,8,8,6,106,27,3,3,-13.549337260677467,0.7955041074145821,0.7775822129451585,-19,5,-24,2.4166666666666665,29,78,548,655,-27.99768915373034
33,2020-12-22,1405.4200439453125,1428.1099853515625,1388.22998046875,1424.3900146484375,12,9,6,6,90,18,2,2,-11.487481590574374,0.7968929963034711,0.7764312348844644,-9,4,-13,2.1166666666666667,399,152,102,653,-26.60442806169187
34,2020-12-23,1422.5899658203125,1440.52001953125,1414.2099609375,1416.02001953125,27,23,16,11,16,3,0,0,1.6200294550810015,0.7985596629701378,0.7753358123793259,20,16,4,1.925,200,179,270,649,-27.228037626154194
35,2020-12-24,1420.5999755859375,1453.8699951171875,1409.75,1451.52001953125,23,18,12,10,30,3,1,1,-1.0309278350515463,0.8017220561325309,0.774367170500968,15,11,4,1.7416666666666667,346,166,138,650,-26.112013888935344
36,2020-12-28,1505.1500244140625,1512.989990234375,1452.47998046875,1452.6700439453125,42,36,25,20,20,5,2,2,3.240058910162003,0.8079874882312962,0.7726130143162686,31,23,8,1.7583333333333333,128,165,360,653,-26.3808816058059
37,2020-12-29,1452.3900146484375,1468.5999755859375,1440.5899658203125,1461.949951171875,26,21,12,9,16,2,0,0,1.4727540500736378,0.8140480942919024,0.771983223915651,19,12,7,1.7166666666666666,333,188,131,652,-25.347061955778358
38,2020-12-30,1467.739990234375,1479.0400390625,1445.3599853515625,1449.3499755859375,29,23,13,13,36,4,0,0,-1.0309278350515463,0.8229369831807912,0.7716497298113296,19,13,6,1.6666666666666667,141,174,339,654,-26.41074826829186
39,2021-01-04,1428.800048828125,1468.27001953125,1425.47998046875,1468.239990234375,24,22,15,13,75,11,0,0,-7.511045655375552,0.8284925387363468,0.7715014208921935,11,15,-4,1.5416666666666667,266,187,201,654,-25.82274768933716
40,2021-01-05,1467.8900146484375,1506.6600341796875,1466.050048828125,1506.6500244140625,51,40,25,16,7,3,1,1,6.480117820324006,0.8337338660364977,0.7715385066437463,37,24,13,1.475,340,160,151,651,-24.739275011565237
41,2021-01-06,1506.56005859375,1514.8900146484375,1485.7900390625,1492.3599853515625,55,47,36,25,7,2,1,1,7.069219440353461,0.8355561428587743,0.7716438424635491,45,35,10,1.3833333333333333,202,173,276,651,-25.391415607082674
42,2021-01-07,1510.6400146484375,1519.9100341796875,1502.81005859375,1513.780029296875,57,45,38,27,8,2,0,0,7.216494845360825,0.8377783650809967,0.7718232523574259,43,38,5,1.2166666666666666,332,197,122,651,-24.3615583059938
43,2021-01-08,1528.1199951171875,1538.6099853515625,1521.1700439453125,1536.43994140625,59,47,36,29,12,2,1,1,6.9219440353460975,0.8384390257416573,0.7720321917808323,45,35,10,1.1583333333333334,203,196,254,653,-24.87036401422727
44,2021-01-11,1539.7900390625,1550.75,1527.75,1536.489990234375,54,40,27,21,11,3,0,0,6.332842415316642,0.839480692408324,0.77226123354342,37,27,10,1.0666666666666667,249,196,209,654,-24.419758105167936
45,2021-01-12,1536.75,1542.6500244140625,1528.5,1539.8499755859375,47,32,22,16,11,3,0,0,5.3019145802650955,0.8431843961120277,0.7725923645747635,29,22,7,0.95,239,200,211,650,-24.046524287585626
46,2021-01-13,1548.300048828125,1561.6600341796875,1542.4200439453125,1547.31005859375,61,45,30,19,10,1,0,0,7.511045655375552,0.8465177294453611,0.7730213792039908,44,30,14,0.9583333333333334,240,204,204,648,-23.62746611012388
47,2021-01-14,1545.3499755859375,1552.780029296875,1533.52001953125,1535.97998046875,54,37,21,14,9,1,0,0,6.62739322533137,0.849642729445361,0.7735236963023537,36,21,15,1.1416666666666666,197,196,255,648,-24.170067477293944
48,2021-01-15,1537.030029296875,1544.1099853515625,1513.47998046875,1519.1300048828125,25,16,11,10,14,4,2,1,1.6200294550810015,0.8540961707409076,0.7741744614439017,12,9,3,1.1833333333333333,168,202,281,651,-24.916157449284867
49,2021-01-18,1511.0400390625,1515.510009765625,1503.0400390625,1510.1300048828125,47,33,22,19,18,1,1,0,4.270986745213549,0.8600381997264148,0.7750353715129857,32,21,11,1.175,204,189,255,648,-25.434251120961697
50,2021-01-19,1519.3699951171875,1529.1700439453125,1518.6600341796875,1522.5899658203125,62,49,33,30,13,0,0,0,7.216494845360825,0.8742048663930816,0.7763685038042921,49,33,16,1.25,273,205,168,646,-24.720312231515216
51,2021-01-20,1524.9100341796875,1529.5,1511.4100341796875,1515.719970703125,54,35,22,21,10,2,0,0,6.480117820324006,0.8844612766494918,0.7780271765681978,33,22,11,1.1916666666666667,173,214,263,650,-25.367308870735847
52,2021-01-21,1525.6300048828125,1529.27001953125,1510.800048828125,1513.510009765625,52,30,13,13,10,4,1,1,6.185567010309279,0.8880327052209204,0.7798136271098812,26,12,14,1.1916666666666667,220,204,230,654,-25.58817192288554
53,2021-01-22,1508.9200439453125,1518.050048828125,1494.449951171875,1497.8800048828125,30,16,9,7,25,4,1,1,0.7363770250368189,0.8937734459616612,0.7818045935709929,12,8,4,1.1666666666666667,113,188,354,655,-26.717389472843152
54,2021-01-25,1498.3599853515625,1505.469970703125,1491.6300048828125,1501.6199951171875,39,24,16,16,29,6,0,0,1.4727540500736378,0.9048845570727723,0.7841427822543267,18,16,2,1.175,235,194,219,648,-26.43094352322738
55,2021-01-26,1497.030029296875,1514.8199462890625,1490.3699951171875,1512.8299560546875,32,23,15,15,20,6,0,0,1.7673048600883652,0.9146067792949945,0.7868050450117344,17,15,2,1.2,243,200,205,648,-25.99613928409423
56,2021-01-27,1510.6800537109375,1515.3199462890625,1498.050048828125,1498.1300048828125,43,33,21,19,18,5,1,1,3.681885125184094,0.9216269813151964,0.7896769037287384,28,20,8,1.2583333333333333,197,205,252,654,-26.51285031674414
57,2021-01-28,1482.5,1492.0,1467.739990234375,1468.510009765625,25,16,12,11,46,6,1,1,-3.0927835051546393,0.929233818922034,0.7927874593366132,10,11,-1,1.4,74,166,409,649,-27.929179383010908
58,2021-01-29,1478.760009765625,1480.43994140625,1455.550048828125,1466.97998046875,19,15,11,10,61,4,0,0,-6.185567010309279,0.9369261266143417,0.796101515147988,11,11,0,1.5583333333333333,211,202,238,651,-28.293877787323808
59,2021-02-01,1465.760009765625,1481.6600341796875,1456.449951171875,1478.050048828125,26,22,16,14,35,4,1,1,-1.3254786450662739,0.9442790677908124,0.7996571675980184,18,15,3,1.6583333333333334,259,210,180,649,-27.681989249321674
60,2021-02-02,1491.02001953125,1496.4599609375,1480.5,1486.25,33,24,18,15,13,6,1,0,2.9455081001472756,0.9467352081416895,0.8032986275154351,18,17,1,1.625,248,197,196,641,-27.169518506131137
61,2021-02-03,1498.5,1500.1700439453125,1481.68994140625,1481.75,35,21,20,18,24,3,0,0,1.6200294550810015,0.9495129859194673,0.8070326800254443,18,20,-2,1.5833333333333333,238,202,206,646,-26.772485172542765
62,2021-02-04,1486.5,1492.3900146484375,1477.8800048828125,1482.97998046875,47,29,25,20,25,5,1,0,3.240058910162003,0.9507238121302934,0.8108177771698318,24,24,0,1.5333333333333334,234,215,198,647,-26.364236882078902
63,2021-02-05,1491.0699462890625,1498.3499755859375,1488.72998046875,1496.6099853515625,47,30,24,18,22,9,0,0,3.681885125184094,0.9528071454636268,0.8146218137081583,21,24,-3,1.6416666666666666,274,214,160,648,-25.636066189082037
64,2021-02-08,1508.449951171875,1517.31005859375,1507.0899658203125,1516.4300537109375,55,28,23,17,21,4,1,0,5.007363770250368,0.9548904787969602,0.8184721465427814,24,22,2,1.75,297,200,159,656,-24.807472703602514
65,2021-02-09,1524.5799560546875,1529.489990234375,1516.5,1518.27001953125,66,32,22,21,8,1,0,0,8.541973490427099,0.9585941825006639,0.8224459361675278,31,22,9,1.7583333333333333,239,226,194,659,-24.36223357070587
66,2021-02-10,1526.3399658203125,1527.8800048828125,1513.1300048828125,1516.93994140625,54,34,22,17,12,6,3,1,6.185567010309279,0.9602978862043675,0.8265098492490643,28,19,9,1.8083333333333333,187,217,248,652,-24.89121042630682
67,2021-02-11,1520.6800537109375,1521.31005859375,1503.18994140625,1508.3499755859375,35,22,16,14,22,4,0,0,1.914580265095729,0.966708142614624,0.8306639807541528,18,16,2,1.9083333333333334,182,234,239,655,-25.38370732121009
68,2021-02-15,1515.9100341796875,1529.97998046875,1513.3299560546875,1522.719970703125,53,34,31,26,17,7,0,0,5.3019145802650955,0.966708142614624,0.8347718159629448,27,31,-4,1.925,218,208,237,663,-25.685218665787854
69,2021-02-16,1528.4300537109375,1531.2900390625,1522.4100341796875,1523.1099853515625,62,39,32,26,17,6,0,0,6.62739322533137,0.96758533559708,0.8388234208523486,33,32,1,2.075,214,210,235,659,-26.00069618693748
70,2021-02-17,1519.739990234375,1528.5799560546875,1513.9599609375,1514.9100341796875,63,43,31,23,23,6,1,0,5.891016200294551,0.9689163541155986,0.8427765584297435,37,30,7,2.466666666666667,202,191,264,657,-26.56895375764522
71,2021-02-18,1519.7900390625,1524.1099853515625,1510.77001953125,1511.030029296875,50,28,23,19,36,13,3,0,2.0618556701030926,0.9703266105258551,0.8466235706510131,15,20,-5,2.8,193,212,256,661,-27.112805435851076
72,2021-02-19,1504.97998046875,1507.6300048828125,1493.52001953125,1500.510009765625,38,27,20,17,40,16,2,0,-0.29455081001472755,0.9688114590107035,0.8503812277829275,11,18,-7,2.925,155,208,299,662,-27.942862792490367
73,2021-02-22,1504.6500244140625,1505.469970703125,1476.5,1478.1400146484375,51,34,25,21,94,30,6,2,-6.332842415316642,0.9655856525590907,0.8540851214739817,4,19,-15,2.933333333333333,102,150,407,659,-29.364083236217827
74,2021-02-23,1487.530029296875,1506.93994140625,1486.1800537109375,1500.6099853515625,44,31,25,22,46,18,8,3,-0.29455081001472755,0.9615452485186867,0.8577216750976959,13,17,-4,2.8833333333333333,328,171,152,651,-28.35252215850008
75,2021-02-24,1503.56005859375,1507.780029296875,1485.93994140625,1491.1099853515625,54,40,29,27,49,17,6,3,0.7363770250368189,0.9586881056615438,0.8613106096737908,23,23,0,2.9,214,184,255,653,-28.82328921514447
76,2021-02-25,1508.8199462890625,1511.300048828125,1494.3599853515625,1496.780029296875,66,45,36,35,39,15,3,3,3.976435935198822,0.9574060543794924,0.8648781767285184,30,33,-3,2.816666666666667,249,175,230,654,-28.494724844808086
77,2021-03-01,1493.550048828125,1505.6099853515625,1487.989990234375,1500.9200439453125,52,35,27,26,62,24,7,3,-1.4727540500736378,0.953974681830473,0.8683885542407623,11,20,-9,2.7333333333333334,225,175,252,652,-28.886399570708406
78,2021-03-02,1503.9100341796875,1509.6500244140625,1500.800048828125,1503.3599853515625,60,42,31,29,32,16,3,2,4.123711340206185,0.9525040935951787,0.8718126935540229,26,28,-2,2.691666666666667,259,180,208,647,-28.355581376030507
79,2021-03-03,1510.27001953125,1543.47998046875,1510.0699462890625,1543.4000244140625,65,40,26,25,18,4,2,1,6.9219440353460975,0.9513136174047025,0.8751336582641088,36,24,12,2.8333333333333335,338,170,140,648,-27.279526202332566
80,2021-03-04,1535.760009765625,1540.6600341796875,1527.8800048828125,1534.1099853515625,80,49,38,37,18,4,1,1,9.131075110456553,0.9508862669773522,0.8783857720720107,45,37,8,2.941666666666667,262,175,211,648,-26.74122078040861
81,2021-03-05,1531.050048828125,1553.9200439453125,1529.8299560546875,1544.1099853515625,69,39,29,27,8,3,0,0,8.98379970544919,0.9508862669773522,0.8816031636576902,36,29,7,3.0166666666666666,263,193,193,649,-26.140533888369138
82,2021-03-08,1559.1700439453125,1562.56005859375,1540.6400146484375,1543.760009765625,108,69,56,51,15,1,0,0,13.69661266568483,0.9508862669773522,0.8847649996878142,68,56,12,3.308333333333333,259,167,225,651,-25.69066618294792
83,2021-03-09,1553.0,1554.9599609375,1537.22998046875,1550.5899658203125,82,50,36,35,26,3,0,0,8.24742268041237,0.9515035509279693,0.887823955059502,47,36,11,3.825,266,184,206,656,-25.121171385496417
84,2021-03-10,1553.27001953125,1573.550048828125,1550.449951171875,1573.050048828125,126,74,47,45,4,1,0,0,17.96759941089838,0.9515035509279693,0.8908366141348935,73,47,26,4.133333333333334,348,186,122,656,-24.02182787697298
85,2021-03-11,1582.68994140625,1584.6099853515625,1569.8699951171875,1575.1300048828125,115,71,49,47,5,3,1,1,16.200294550810014,0.951170217594636,0.8937742732102849,68,48,20,4.458333333333333,256,183,220,659,-23.57950200850829
86,2021-03-12,1579.7099609375,1584.4000244140625,1562.9000244140625,1568.18994140625,67,45,38,35,4,1,0,0,9.278350515463918,0.9516331805575989,0.8966876818447591,44,38,6,4.841666666666667,213,189,255,657,-24.049664354489916
87,2021-03-15,1573.1099853515625,1575.9599609375,1562.68994140625,1565.72998046875,76,50,42,38,3,0,0,0,10.751104565537556,0.9516331805575989,0.8995702262817028,50,42,8,5.125,291,174,192,657,-23.297524549856305
88,2021-03-16,1569.010009765625,1573.1300048828125,1562.3499755859375,1564.030029296875,81,59,45,43,4,3,0,0,11.34020618556701,0.9516331805575989,0.9023138818297574,56,45,11,5.4,250,194,209,653,-22.8389872991815
89,2021-03-17,1562.9200439453125,1571.530029296875,1559.219970703125,1566.760009765625,72,54,44,40,3,1,0,0,10.1620029455081,0.9516331805575989,0.9049583310286057,53,44,9,5.675,239,195,219,653,-22.51954901668153
90,2021-03-18,1579.719970703125,1583.300048828125,1567.6700439453125,1568.8199462890625,81,57,43,39,4,0,0,0,11.34020618556701,0.9516331805575989,0.9075194468941206,57,43,14,5.958333333333333,236,200,217,653,-22.212095990701823
91,2021-03-19,1562.300048828125,1566.6700439453125,1554.9599609375,1563.9599609375,69,56,47,44,6,1,0,0,9.278350515463918,0.9561786351030536,0.9101973556889285,55,47,8,6.058333333333334,246,186,216,648,-21.811561588325908
92,2021-03-22,1563.56005859375,1571.739990234375,1555.3800048828125,1566.3599853515625,106,87,66,64,3,2,1,0,15.169366715758468,0.9600965455508148,0.9129174148430509,85,65,20,6.633333333333334,292,171,185,648,-21.022832849623043
93,2021-03-23,1572.699951171875,1574.1400146484375,1562.030029296875,1564.25,117,87,64,63,2,1,0,0,16.936671575846834,0.9600965455508148,0.9156096962193954,86,64,22,7.05,241,173,243,657,-21.130044103106822
94,2021-03-24,1557.5,1570.8399658203125,1555.719970703125,1570.8299560546875,113,82,67,65,8,3,0,0,15.463917525773196,0.9613785968328661,0.9182706385644009,79,67,12,7.616666666666666,295,186,172,653,-20.319023751515576
95,2021-03-25,1576.27001953125,1580.1700439453125,1571.0400390625,1571.0400390625,103,76,63,63,1,0,0,0,15.022091310751104,0.9613785968328661,0.9208621364649621,76,63,13,8.025,211,180,260,651,-20.839329653888594
96,2021-03-26,1577.469970703125,1580.739990234375,1566.8900146484375,1574.8599853515625,62,40,33,32,3,1,0,0,8.689248895434462,0.9626131647341007,0.9234392310733421,39,33,6,8.15,218,189,250,657,-21.249720994722654
97,2021-03-29,1582.72998046875,1592.469970703125,1580.9000244140625,1583.8900146484375,90,64,46,46,3,1,0,0,12.812960235640649,0.9626131647341007,0.9259153155807122,63,46,17,8.325,323,194,136,653,-20.270448632724033
98,2021-03-30,1589.6800537109375,1593.52001953125,1585.06005859375,1589.530029296875,84,62,46,43,2,0,0,0,12.076583210603829,0.9626131647341007,0.9282432519399341,62,46,16,8.658333333333333,241,200,215,656,-19.91079152681502
99,2021-03-31,1592.260009765625,1593.9300537109375,1585.5799560546875,1587.2099609375,55,48,41,40,7,2,0,0,7.069219440353461,0.9626131647341007,0.9304785957065633,46,41,5,8.9,214,205,240,659,-20.26605705037875
100,2021-04-01,1594.010009765625,1600.5999755859375,1590.3299560546875,1595.1199951171875,78,67,52,49,3,0,0,0,11.045655375552283,0.9632541903751263,0.9326372677788738,67,52,15,9.333333333333334,287,186,183,656,-19.52030257830344
101,2021-04-05,1599.3299560546875,1601.239990234375,1575.56005859375,1579.6600341796875,55,47,41,40,13,1,0,0,6.185567010309279,0.9637046408255768,0.9368718473407301,46,41,5,9.583333333333334,118,140,395,653,-21.167819270874944
102,2021-04-07,1566.1099853515625,1570.68994140625,1555.5699462890625,1556.56005859375,31,21,19,19,74,7,0,0,-6.332842415316642,0.9641550912760272,0.9389671150996364,14,19,-5,9.55,75,117,460,652,-22.97411710467943
103,2021-04-08,1554.6400146484375,1564.050048828125,1552.1800537109375,1558.8299560546875,37,31,25,24,55,5,0,0,-2.6509572901325478,0.9641550912760272,0.9410450217474313,26,25,1,9.516666666666667,269,198,186,653,-22.328295591306208
104,2021-04-09,1562.199951171875,1572.1300048828125,1561.760009765625,1566.3399658203125,45,37,33,33,12,2,0,0,4.860088365243004,0.9641550912760272,0.9430612000001647,35,33,2,9.558333333333334,215,222,216,653,-22.39526054432445
105,2021-04-12,1561.530029296875,1562.0699462890625,1539.239990234375,1541.1199951171875,28,24,20,19,95,17,0,0,-9.867452135493373,0.9641550912760272,0.9450218226973424,7,20,-13,9.458333333333334,69,137,447,653,-24.050292397426563
106,2021-04-16,1543.5899658203125,1550.260009765625,1529.2900390625,1548.9599609375,22,16,13,12,147,26,0,0,-18.40942562592047,0.9641550912760272,0.9469303620611869,-10,13,-23,9.275,214,152,291,657,-24.759706221549134
107,2021-04-19,1555.010009765625,1574.969970703125,1552.9100341796875,1574.9100341796875,40,30,28,28,13,2,0,0,3.976435935198822,0.9667191938401297,0.9488074124461738,28,28,0,9.466666666666667,476,122,62,660,-22.925079922125576
108,2021-04-20,1574.3800048828125,1582.489990234375,1570.530029296875,1580.0400390625,46,39,36,36,3,0,0,0,6.332842415316642,0.9674438315212891,0.9505975063094219,39,36,3,9.85,255,172,231,658,-22.552617408979057
109,2021-04-21,1576.18994140625,1584.5699462890625,1575.56005859375,1580.010009765625,63,55,50,50,8,2,0,0,8.100147275405007,0.9674438315212891,0.9521514890615586,53,50,3,10.783333333333333,316,177,160,653,-21.61645262947599
110,2021-04-22,1585.9100341796875,1587.949951171875,1564.8299560546875,1568.2099609375,65,59,55,55,9,1,0,0,8.24742268041237,0.9674438315212891,0.9535345316427553,58,55,3,11.241666666666667,157,181,315,653,-22.548188572826824
111,2021-04-23,1563.4599609375,1564.6199951171875,1550.6199951171875,1553.5899658203125,41,34,29,29,41,10,1,1,0.0,0.9680787521562098,0.95486863242501,24,28,-4,11.366666666666667,138,166,349,653,-23.672231745437294
112,2021-04-26,1552.050048828125,1561.52001953125,1544.0999755859375,1559.530029296875,69,62,58,57,49,13,2,1,2.9455081001472756,0.9691898632673208,0.9561255727134377,49,56,-7,11.55,273,181,200,654,-23.038908051660645
113,2021-04-27,1564.06005859375,1570.5799560546875,1553.030029296875,1559.22998046875,93,82,77,77,20,8,1,0,10.751104565537556,0.9689761880536456,0.9571937665631189,74,76,-2,11.7,227,192,236,655,-23.254852776885254
114,2021-04-28,1565.699951171875,1578.6199951171875,1562.8399658203125,1576.7900390625,74,62,58,58,14,4,1,1,8.836524300441827,0.9686937021779394,0.9580952152778347,58,57,1,11.95,372,159,124,655,-22.009862817086383
115,2021-04-29,1584.550048828125,1592.9000244140625,1583.97998046875,1590.4599609375,70,57,49,48,9,0,0,0,8.98379970544919,0.9694512779355152,0.9588922868881732,57,49,8,12.116666666666667,283,185,189,657,-21.298964551449153
116,2021-04-30,1591.1199951171875,1593.22998046875,1580.739990234375,1583.1300048828125,69,57,51,51,11,3,0,0,8.541973490427099,0.9707333292175665,0.9595839453930989,54,51,3,12.425,249,189,224,662,-20.936226426394146
117,2021-05-05,1581.8599853515625,1583.27001953125,1547.3499755859375,1549.219970703125,73,60,53,49,40,8,2,2,4.860088365243004,0.9701272686115059,0.9601372977597182,52,51,1,12.658333333333333,142,142,375,659,-22.212694455516157
118,2021-05-06,1553.27001953125,1575.3699951171875,1551.4200439453125,1571.9100341796875,65,48,45,44,27,7,0,0,5.596465390279823,0.9711076607683685,0.9605844409760108,41,45,-4,12.766666666666667,333,178,147,658,-21.19332889535072
119,2021-05-07,1582.25,1589.2099609375,1577.18994140625,1585.030029296875,67,49,45,44,14,5,2,2,7.80559646539028,0.9712756338926687,0.9609934480718605,44,43,1,12.725,274,178,203,655,-20.563528891625143
120,2021-05-10,1596.6099853515625,1596.800048828125,1576.7900390625,1588.1500244140625,67,50,45,43,28,8,2,2,5.743740795287187,0.9705664140345127,0.9613443385404447,42,43,-1,12.691666666666666,249,170,240,659,-20.334113157754583
121,2021-05-11,1579.25,1590.5400390625,1566.9100341796875,1578.9300537109375,51,37,32,31,51,20,7,5,0.0,0.9682159866840853,0.9616358747830077,17,25,-8,12.575,137,154,368,659,-21.55490084635779
122,2021-05-12,1576.6600341796875,1578.3399658203125,1557.93994140625,1571.8499755859375,54,42,38,37,74,28,7,5,-2.9455081001472756,0.9656233940914928,0.9618494789268055,14,31,-17,12.375,188,140,331,659,-22.561968072099507
123,2021-05-13,1554.0999755859375,1561.800048828125,1501.02001953125,1548.1300048828125,31,24,23,23,212,78,12,9,-26.656848306332844,0.9606035528216516,0.9619446968272171,-54,11,-65,11.75,86,119,457,662,-24.320281658086564
124,2021-05-14,1555.719970703125,1558.8599853515625,1532.2900390625,1549.47998046875,33,24,19,19,24,7,2,2,1.3254786450662739,0.95901625123435,0.9619517313061119,17,17,0,11.55,231,145,287,663,-24.939605195371897
125,2021-05-17,1542.22998046875,1554.0799560546875,1529.68994140625,1549.1600341796875,38,30,25,25,65,24,4,3,-3.976435935198822,0.9587174006596373,0.9619253898803665,6,21,-15,11.208333333333334,199,150,309,658,-25.793113731469838
126,2021-05-18,1559.9300537109375,1570.3699951171875,1558.8499755859375,1566.800048828125,49,36,32,31,12,1,0,0,5.44918998527246,0.9587174006596373,0.9617922108477832,35,32,3,11.141666666666667,377,136,142,655,-24.483408242761293
127,2021-05-19,1561.969970703125,1570.050048828125,1557.8299560546875,1562.239990234375,43,37,33,33,11,5,1,1,4.712812960235641,0.9582272045812059,0.9616508618805597,32,32,0,11.041666666666666,267,161,223,651,-23.962250936114245
128,2021-05-20,1565.3900146484375,1568.719970703125,1554.5400390625,1554.5400390625,46,35,32,31,17,2,1,1,4.270986745213549,0.9577221540761554,0.9614864755218775,33,31,2,10.775,187,155,310,652,-24.850204503853874
129,2021-05-21,1559.8199462890625,1560.510009765625,1546.550048828125,1552.43994140625,25,18,15,15,15,4,1,1,1.4727540500736378,0.957201320742822,0.9612912249656647,14,14,0,10.541666666666666,169,172,312,653,-25.759374232439093
130,2021-05-24,1555.22998046875,1559.5999755859375,1547.1400146484375,1551.8499755859375,34,26,21,21,27,9,4,3,1.0309278350515463,0.9564577309992324,0.9610600769735542,17,17,0,10.458333333333334,212,179,265,656,-26.302001585642415
131,2021-05-25,1562.8900146484375,1572.030029296875,1560.1300048828125,1568.5799560546875,38,24,19,18,14,3,2,2,3.5346097201767304,0.9563855809270823,0.9608529790054939,21,17,4,10.2,309,192,153,654,-25.40295200111417
132,2021-05-27,1570.5,1587.5400390625,1568.8900146484375,1582.9599609375,35,19,16,15,5,2,1,1,4.418262150220913,0.9586309952218323,0.9607370680498729,17,15,2,9.791666666666666,315,177,168,660,-24.494193124057546
133,2021-05-28,1590.43994140625,1595.449951171875,1579.530029296875,1581.97998046875,45,25,23,21,3,2,0,0,6.185567010309279,0.9626713992622363,0.9607558372289321,23,23,0,9.016666666666667,241,164,249,654,-24.71438587708282
134,2021-05-31,1582.56005859375,1594.6500244140625,1578.0899658203125,1593.5899658203125,49,34,30,27,14,7,1,1,5.154639175257732,0.9649909077107771,0.9608608839297527,27,29,-2,8.475,298,173,179,650,-23.887398545875737
135,2021-06-01,1602.6500244140625,1620.530029296875,1598.6600341796875,1618.5899658203125,67,39,36,35,5,3,2,2,9.131075110456553,0.9653957660103722,0.9609940457902673,36,34,2,8.166666666666666,308,183,164,655,-23.002746808946355
136,2021-06-02,1624.8299560546875,1627.6700439453125,1612.93994140625,1617.550048828125,65,36,33,32,2,1,0,0,9.278350515463918,0.9688271385593918,0.9612415867357492,35,33,2,7.808333333333334,250,189,218,657,-22.592355468112295
137,2021-06-04,1613.719970703125,1622.8900146484375,1611.3399658203125,1611.530029296875,71,35,33,32,7,2,0,0,9.425625920471282,0.970297726794686,0.9615381472890744,33,33,0,7.275,272,167,218,657,-22.025408758598456
138,2021-06-07,1618.739990234375,1625.56005859375,1611.780029296875,1612.5899658203125,82,37,32,29,3,1,0,0,11.634756995581737,0.9714882029851621,0.961874390382082,36,32,4,7.041666666666667,264,155,236,655,-21.601749485730295
139,2021-06-08,1614.8499755859375,1618.699951171875,1605.31005859375,1612.8800048828125,63,25,21,19,12,4,0,0,7.511045655375552,0.9719155534125126,0.9622248784893347,21,21,0,6.841666666666667,200,192,263,655,-22.173085525610784
140,2021-06-09,1618.06005859375,1628.4200439453125,1617.8299560546875,1626.27001953125,63,19,16,14,3,1,0,0,8.836524300441827,0.9719155534125126,0.9625753665965873,18,16,2,6.625,286,198,169,653,-21.406313265749706
141,2021-06-10,1631.9200439453125,1636.219970703125,1623.5699462890625,1625.27001953125,72,30,24,23,5,1,0,0,9.867452135493373,0.9719155534125126,0.9629258547038401,29,24,5,6.383333333333334,197,181,276,654,-22.065150069568325
142,2021-06-11,1632.0400390625,1636.9200439453125,1628.1400146484375,1636.56005859375,75,36,28,24,6,3,1,1,10.1620029455081,0.9713408407688344,0.9632564762011878,33,27,6,6.0,242,205,210,657,-21.671018358302607
143,2021-06-14,1641.6800537109375,1642.800048828125,1629.3299560546875,1633.06005859375,65,21,20,18,8,3,0,0,8.394698085419735,0.9713408407688344,0.9635870976985355,18,20,-2,5.316666666666666,180,183,292,655,-22.451207855908102
144,2021-06-15,1634.449951171875,1636.0999755859375,1618.5999755859375,1622.31005859375,57,25,21,21,17,5,0,0,5.891016200294551,0.9716741741021678,0.9639288303069943,20,21,-1,4.725,165,167,323,655,-23.42098937278507
145,2021-06-16,1622.780029296875,1631.22998046875,1619.22998046875,1624.7900390625,49,26,16,15,7,1,0,0,6.185567010309279,0.9716741741021678,0.9642628468660706,25,16,9,4.416666666666667,261,185,207,653,-22.882173466704746
146,2021-06-17,1621.3800048828125,1631.68994140625,1615.6199951171875,1617.6500244140625,54,32,27,23,14,4,0,0,5.891016200294551,0.9716741741021678,0.9645968634251467,28,27,1,4.166666666666667,162,200,293,655,-23.689478423664838
147,2021-06-18,1619.8800048828125,1622.4300537109375,1604.43994140625,1612.97998046875,34,24,13,13,30,4,0,0,0.5891016200294551,0.9716741741021678,0.9649308799842229,20,13,7,3.7583333333333333,175,175,309,659,-24.56203996095813
148,2021-06-21,1596.9599609375,1602.6600341796875,1590.550048828125,1601.1300048828125,27,16,12,11,75,6,0,0,-7.069219440353461,0.9716741741021678,0.965264896543299,10,12,-2,3.2,142,153,360,655,-25.751823309128888
149,2021-06-22,1610.8499755859375,1613.6600341796875,1598.56005859375,1599.22998046875,37,22,19,18,13,1,0,0,3.5346097201767304,0.9716741741021678,0.9655989131023751,21,19,2,2.783333333333333,212,203,238,653,-26.108826082776595
150,2021-06-23,1605.31005859375,1606.3900146484375,1590.6300048828125,1592.0799560546875,33,15,14,14,47,7,1,1,-2.0618556701030926,0.9705630629910567,0.9658386535671752,8,13,-5,2.941666666666667,117,167,365,649,-27.323811875364505
151,2021-06-24,1587.72998046875,1589.3299560546875,1569.9300537109375,1585.719970703125,18,10,8,8,127,17,1,1,-16.05301914580265,0.9689599673581102,0.9659863772639634,-7,7,-14,2.933333333333333,144,152,361,657,-28.51473616078099
152,2021-06-25,1592.02001953125,1596.1600341796875,1577.6300048828125,1582.6700439453125,21,12,12,12,44,5,1,1,-3.3873343151693667,0.967677916076059,0.9661127334393842,7,11,-4,2.8666666666666667,170,198,290,658,-29.29127661393001
153,2021-06-28,1572.1800537109375,1581.3399658203125,1565.31005859375,1579.1700439453125,21,14,14,14,144,23,1,0,-18.114874815905743,0.9665668049649478,0.9661992035749188,-9,13,-22,2.65,207,188,263,658,-29.835607667881828
154,2021-06-29,1580.8900146484375,1596.0799560546875,1579.43994140625,1591.4300537109375,27,15,14,14,18,6,0,0,1.3254786450662739,0.9665668049649478,0.9662856737104536,9,14,-5,2.533333333333333,339,179,134,652,-28.76842029497635
155,2021-06-30,1597.260009765625,1600.5699462890625,1584.469970703125,1587.7900390625,27,19,16,16,18,5,0,0,1.3254786450662739,0.9665668049649478,0.9663515677143011,14,16,-2,2.45,223,166,257,646,-29.219632899378375
156,2021-07-01,1591.0400390625,1596.3599853515625,1584.68994140625,1593.75,22,14,12,12,16,4,0,0,0.8836524300441826,0.9665668049649478,0.9664174617181485,10,12,-2,2.375,298,178,172,648,-28.380639088599573
157,2021-07-02,1591.3699951171875,1596.050048828125,1574.9200439453125,1578.489990234375,19,15,13,13,38,10,0,0,-2.7982326951399115,0.9665668049649478,0.966483355721996,5,13,-8,2.2583333333333333,83,149,419,651,-29.87730204330915
158,2021-07-05,1580.68994140625,1582.4599609375,1573.6700439453125,1579.280029296875,29,16,16,16,75,18,1,1,-6.774668630338733,0.9655864128080851,0.9665329098565624,-2,15,-17,2.15,177,188,282,647,-30.62265803580908
159,2021-07-06,1585.9599609375,1594.1500244140625,1585.3399658203125,1591.4300537109375,36,22,19,19,23,5,0,0,1.914580265095729,0.9655864128080851,0.966571780230445,17,19,-2,2.025,348,172,129,649,-29.497537618361587
160,2021-07-07,1585.0400390625,1587.699951171875,1574.1400146484375,1576.5999755859375,29,19,18,18,69,19,4,4,-5.891016200294551,0.9625561097777822,0.9665526380463151,0,14,-14,1.825,100,146,403,649,-30.93323413566457
161,2021-07-08,1563.9599609375,1567.3299560546875,1540.56005859375,1543.6700439453125,19,15,15,15,289,75,8,7,-39.76435935198822,0.9567590083285068,0.9664368775046973,-60,7,-67,1.225,65,93,498,656,-33.079482718360296
162,2021-07-09,1537.969970703125,1554.5999755859375,1535.68994140625,1552.0899658203125,18,14,11,11,247,76,11,9,-33.726067746686304,0.9484256749951734,0.966174720566683,-62,0,-62,0.625,288,181,182,651,-32.31631983770009
163,2021-07-12,1558.6300048828125,1561.719970703125,1544.7099609375,1549.8399658203125,27,15,13,13,40,16,2,2,-1.914580265095729,0.9462034527729511,0.9658755265916317,-1,11,-12,0.44166666666666665,216,188,247,651,-32.72131510189606
164,2021-07-13,1557.260009765625,1571.8199462890625,1555.8800048828125,1570.989990234375,23,9,7,7,22,10,3,2,0.14727540500736377,0.9412034527729511,0.9654929992832472,-1,4,-5,0.3416666666666667,431,128,91,650,-31.09784384722948
165,2021-07-14,1570.1199951171875,1573.0400390625,1561.0,1569.699951171875,32,19,15,15,9,4,0,0,3.3873343151693667,0.9412034527729511,0.9651104719748624,15,15,0,0.225,254,201,190,645,-30.534965811445247
166,2021-07-15,1575.050048828125,1580.4300537109375,1570.9599609375,1572.010009765625,40,21,16,16,9,4,0,0,4.565537555228277,0.9412034527729511,0.9647279446664779,17,16,1,0.10833333333333334,241,183,220,644,-30.19713384909916
167,2021-07-16,1569.22998046875,1575.6600341796875,1567.1700439453125,1574.3699951171875,30,13,9,9,6,3,0,0,3.5346097201767304,0.9412034527729511,0.9643026823153583,10,9,1,0.09166666666666666,255,211,178,644,-29.594466820658237
168,2021-07-19,1557.81005859375,1563.8800048828125,1551.7900390625,1556.010009765625,22,11,9,9,28,8,2,2,-0.8836524300441826,0.9381731497426481,0.9638148376190475,3,7,-4,-0.03333333333333333,83,145,411,639,-31.093324833435215
169,2021-07-20,1551.260009765625,1552.3800048828125,1530.6199951171875,1538.8599853515625,22,13,9,9,79,35,3,2,-8.394698085419735,0.9340064830759814,0.9632575484782925,-22,6,-28,-0.4,89,134,419,642,-32.656796753376355
170,2021-07-21,1543.1700439453125,1545.3900146484375,1532.3399658203125,1540.8800048828125,17,10,7,7,49,24,1,1,-4.712812960235641,0.9319231497426481,0.9626655371153151,-14,6,-20,-0.6583333333333333,222,211,214,647,-32.4625395809049
171,2021-07-22,1549.8499755859375,1554.6500244140625,1546.260009765625,1552.3599853515625,22,13,10,10,14,6,0,0,1.1782032400589102,0.9324787052982038,0.962072203001015,7,10,-3,-0.8,322,195,134,651,-31.483160352276183
172,2021-07-23,1550.8599853515625,1553.25,1540.3499755859375,1545.0999755859375,19,7,6,6,35,15,1,1,-2.3564064801178204,0.9306533084728069,0.9614299270877731,-8,5,-13,-0.9416666666666667,163,192,290,645,-32.2943515061252
173,2021-07-27,1547.4000244140625,1551.4300537109375,1531.81005859375,1537.6300048828125,48,23,18,18,57,27,3,3,-1.3254786450662739,0.9284860313055298,0.9607550911419712,-4,15,-19,-1.1166666666666667,170,154,321,645,-33.281363941906584
174,2021-07-29,1541.800048828125,1545.0799560546875,1533.93994140625,1537.780029296875,33,20,14,14,78,39,6,5,-6.62739322533137,0.9237685171812359,0.9600063380586927,-19,8,-27,-1.3583333333333334,186,169,296,651,-34.08576360844643
175,2021-07-30,1536.9100341796875,1539.030029296875,1516.77001953125,1521.9200439453125,19,12,9,9,148,84,14,11,-18.998527245949926,0.9136235896450041,0.9590758765871843,-72,-5,-67,-1.9833333333333334,95,144,408,647,-35.55498812827149
176,2021-08-02,1523.4200439453125,1525.72998046875,1513.7099609375,1525.1099853515625,22,16,12,12,151,90,16,12,-18.998527245949926,0.9040997801211945,0.957965317435578,-74,-4,-70,-2.558333333333333,182,159,306,647,-36.43532897135444
177,2021-08-03,1525.239990234375,1540.52001953125,1524.3699951171875,1540.510009765625,28,20,16,15,44,24,5,3,-2.3564064801178204,0.9007375867590013,0.9568088227380364,-4,11,-15,-2.683333333333333,403,142,100,645,-34.97969126956147
178,2021-08-04,1542.1099853515625,1548.6300048828125,1533.3599853515625,1545.8599853515625,45,23,15,15,19,8,2,1,3.829160530191458,0.8987768024452758,0.9556033084326514,15,13,2,-2.691666666666667,238,200,206,644,-34.580687535118415
179,2021-08-05,1544.8299560546875,1547.3800048828125,1526.9100341796875,1527.6600341796875,36,22,17,17,18,7,0,0,2.6509572901325478,0.8994860223034318,0.9544068149061642,15,17,-2,-2.716666666666667,167,186,294,647,-35.40478970416467
180,2021-08-06,1530.4300537109375,1537.27001953125,1514.6700439453125,1521.719970703125,28,21,18,18,42,25,4,4,-2.0618556701030926,0.8971649391312847,0.9531834569911104,-4,14,-18,-2.85,159,180,307,646,-36.309046060521126
181,2021-08-09,1528.1600341796875,1543.7099609375,1525.2900390625,1540.18994140625,50,16,13,13,26,15,3,2,3.5346097201767304,0.8970313921227377,0.9519970470817546,1,10,-9,-2.925,315,157,171,643,-35.35437731951025
182,2021-08-10,1544.31005859375,1551.6099853515625,1539.4000244140625,1542.6199951171875,58,19,14,14,4,1,0,0,7.952871870397644,0.8996239847153302,0.9508970569254853,18,14,4,-2.8666666666666667,302,172,174,648,-34.4942119905975
183,2021-08-11,1549.4100341796875,1550.739990234375,1531.5799560546875,1532.7099609375,52,22,16,15,27,14,2,2,3.681885125184094,0.9034864185777641,0.9499451046880871,8,14,-6,-2.933333333333333,153,153,343,649,-35.60496229276547
184,2021-08-13,1530.6800537109375,1541.0799560546875,1525.510009765625,1528.3199462890625,24,5,4,4,91,51,6,5,-9.867452135493373,0.8950737201650657,0.9488793958369324,-46,-2,-44,-3.375,126,134,391,651,-37.006020094200856
185,2021-08-16,1527.0799560546875,1532.93994140625,1512.280029296875,1531.239990234375,27,9,5,4,185,114,12,11,-23.269513991163475,0.8856078648574255,0.9476609035735621,-105,-7,-98,-4.266666666666667,186,154,312,652,-37.90763155475715
186,2021-08-17,1536.93994140625,1545.949951171875,1533.3199462890625,1544.219970703125,31,14,11,10,25,14,2,2,0.8836524300441826,0.8830437622933229,0.9463996762674569,0,9,-9,-4.358333333333333,311,170,168,649,-36.99316050002577
187,2021-08-18,1546.7099609375,1557.0799560546875,1545.3299560546875,1551.8699951171875,40,12,8,7,19,11,0,0,3.0927835051546393,0.8835339583717544,0.9451547888306328,1,8,-7,-4.383333333333334,311,193,140,644,-36.054308382294195
188,2021-08-19,1546.699951171875,1553.9000244140625,1543.75,1544.280029296875,48,21,16,16,18,11,0,0,4.418262150220913,0.8840390088768049,0.9439267364106436,10,16,-6,-4.441666666666666,218,191,240,649,-36.39280998248736
189,2021-08-20,1549.9200439453125,1554.449951171875,1545.9200439453125,1553.1800537109375,57,25,13,13,18,11,0,0,5.743740795287187,0.8850806755434716,0.942724725657321,14,13,1,-4.491666666666666,309,178,168,655,-35.50527998456802
190,2021-08-23,1566.0999755859375,1583.1300048828125,1565.9300537109375,1582.0699462890625,94,16,8,8,11,4,0,0,12.223858615611192,0.8877473422101382,0.9415795525108361,12,8,4,-4.416666666666667,357,133,163,653,-34.302050499378325
191,2021-08-24,1590.1199951171875,1598.3900146484375,1585.4599609375,1586.97998046875,90,12,10,9,5,3,0,0,12.51840942562592,0.8893346437974398,0.9404620368920088,9,10,-1,-4.366666666666666,292,172,188,652,-33.52670794968551
192,2021-08-25,1591.2900390625,1601.0899658203125,1588.3699951171875,1600.489990234375,64,12,7,7,1,0,0,0,9.278350515463918,0.8903150359543025,0.9393234375708832,12,7,5,-4.2,332,180,139,651,-32.494090720243044
193,2021-08-26,1601.989990234375,1603.989990234375,1595.68994140625,1601.9100341796875,69,16,10,10,4,1,0,0,9.572901325478645,0.8903150359543025,0.9381174981824177,15,10,5,-4.125,228,191,229,648,-32.56625950389175
194,2021-08-27,1602.1600341796875,1615.219970703125,1600.0,1611.199951171875,79,13,8,8,3,0,0,0,11.192930780559646,0.8908526703629047,0.9368818608932865,13,8,5,-4.083333333333333,264,199,191,654,-31.96210720521202
195,2021-08-30,1621.6800537109375,1634.9200439453125,1621.4200439453125,1633.77001953125,152,25,12,12,4,1,0,0,21.79675994108984,0.8917298633453609,0.9356540958488696,24,12,12,-3.9583333333333335,358,160,135,653,-30.785207393120157
196,2021-08-31,1632.6500244140625,1643.760009765625,1628.1199951171875,1638.75,100,21,11,10,5,0,0,0,13.991163475699558,0.8917298633453609,0.9343691412619691,21,11,10,-3.8,236,168,251,655,-31.083129188982266
197,2021-09-01,1643.010009765625,1646.0699462890625,1628.1600341796875,1634.47998046875,58,16,4,4,4,0,0,0,7.952871870397644,0.8917298633453609,0.9330596768711471,16,4,12,-3.683333333333333,155,162,335,652,-32.133983355138355
198,2021-09-02,1634.25,1652.030029296875,1633.1199951171875,1647.75,45,22,12,12,4,0,0,0,6.0382916053019144,0.8917298633453609,0.9317303712104837,22,12,10,-3.7,245,192,214,651,-31.73320690665612
199,2021-09-03,1654.0,1657.7900390625,1644.1199951171875,1650.3299560546875,55,24,17,17,2,1,1,1,7.80559646539028,0.8908039374194349,0.9303785109439324,23,16,7,-3.7083333333333335,203,179,268,650,-32.33413211923345
200,2021-09-06,1652.3299560546875,1655.0400390625,1644.56005859375,1648.3699951171875,80,25,15,15,7,0,0,0,10.751104565537556,0.8908039374194349,0.9290266506773811,25,15,10,-3.683333333333333,265,174,212,651,-31.783807539683217
201,2021-09-07,1653.6700439453125,1658.0799560546875,1635.1099853515625,1636.449951171875,69,26,11,11,22,5,2,1,6.9219440353460975,0.8882398348553323,0.9276320553680948,21,9,12,-3.683333333333333,123,161,367,651,-33.01106987492624
202,2021-09-08,1632.1800537109375,1641.2900390625,1627.1700439453125,1640.449951171875,52,26,16,16,20,5,1,1,4.712812960235641,0.8878341553421476,0.92624027727765,21,15,6,-3.725,265,187,195,647,-32.400872836641135
203,2021-09-09,1637.6500244140625,1646.0699462890625,1626.949951171875,1629.1199951171875,50,24,18,18,10,5,1,1,5.891016200294551,0.8869569623596915,0.9248338793041643,19,17,2,-3.925,206,174,266,646,-32.986412880410256
204,2021-09-10,1633.0999755859375,1639.6500244140625,1620.5799560546875,1635.3499755859375,51,27,17,17,13,2,0,0,5.596465390279823,0.8869569623596915,0.923421925775123,25,17,8,-4.025,272,179,200,651,-32.35395734837658
205,2021-09-13,1634.4300537109375,1642.6300048828125,1627.2900390625,1633.760009765625,70,31,14,14,19,7,2,2,7.511045655375552,0.8848736290263581,0.9219752500238595,24,12,12,-3.975,274,187,195,656,-31.705719146819895
206,2021-09-14,1639.9000244140625,1640.4000244140625,1621.9599609375,1623.8399658203125,53,22,12,12,15,6,3,2,5.596465390279823,0.8815402956930248,0.9204730187170403,16,9,7,-3.9833333333333334,211,182,259,652,-32.21786666655148
207,2021-09-15,1624.1700439453125,1630.050048828125,1620.8399658203125,1628.0400390625,46,23,14,13,9,4,1,1,5.44918998527246,0.8804291845819137,0.9189522688917028,19,13,6,-4.025,246,195,209,650,-31.783383628673036
208,2021-09-16,1633.280029296875,1636.010009765625,1628.5699462890625,1631.699951171875,45,15,8,8,9,2,1,1,5.3019145802650955,0.8785773327300619,0.9174006548688346,13,7,6,-4.05,226,219,204,649,-31.4671558626562
209,2021-09-17,1632.1800537109375,1635.0400390625,1617.31005859375,1625.6500244140625,30,15,13,12,17,1,0,0,1.914580265095729,0.8785773327300619,0.9158490408459661,14,13,1,-4.158333333333333,157,176,316,649,-32.414945440962356
210,2021-09-20,1617.43994140625,1620.719970703125,1601.1600341796875,1603.06005859375,29,16,9,9,51,8,1,1,-3.240058910162003,0.8780217771745064,0.9143066860823568,8,8,0,-4.225,89,127,432,648,-34.051920547675955
211,2021-09-21,1604.6400146484375,1618.18994140625,1591.81005859375,1614.8599853515625,23,14,8,8,85,12,1,1,-9.131075110456553,0.8780217771745064,0.9127910495792968,2,7,-5,-4.433333333333334,343,187,119,649,-32.960366901856325
212,2021-09-22,1614.739990234375,1623.8599853515625,1611.760009765625,1619.5899658203125,37,26,14,14,9,2,0,0,4.123711340206185,0.8793038284565575,0.9113181481189717,24,14,10,-4.533333333333333,298,208,149,655,-32.11602179451746
213,2021-09-23,1632.9200439453125,1637.6500244140625,1623.0,1631.1500244140625,42,25,12,12,31,5,2,2,1.6200294550810015,0.8780339871867164,0.9098426011560012,20,10,10,-4.55,148,184,316,648,-33.06896885921104
214,2021-09-27,1637.300048828125,1639.969970703125,1616.5999755859375,1620.02001953125,47,31,12,11,80,18,3,3,-4.860088365243004,0.874700653853383,0.9083114986374752,13,9,4,-4.625,133,148,370,651,-34.33016036998394
215,2021-09-28,1623.8800048828125,1626.550048828125,1614.31005859375,1616.5,42,26,11,10,71,15,2,1,-4.270986745213549,0.8721365512892805,0.906737661076214,11,9,2,-4.658333333333333,226,193,233,652,-34.520114243929186
216,2021-09-29,1605.18994140625,1622.6199951171875,1604.4599609375,1616.97998046875,22,17,7,7,60,13,2,2,-5.596465390279823,0.8684328475855768,0.9051020951198911,4,5,-1,-4.808333333333334,255,207,191,653,-33.96541404770396
217,2021-09-30,1616.989990234375,1621.1500244140625,1601.7900390625,1605.6800537109375,28,17,8,7,44,9,2,2,-2.3564064801178204,0.8650995142522434,0.9034109736080127,8,6,2,-4.925,147,165,338,650,-35.0380754153492
218,2021-10-01,1600.5899658203125,1609.47998046875,1593.3199462890625,1605.1700439453125,21,16,8,8,76,19,3,3,-8.100147275405007,0.8615344518636516,0.9016767742589388,-3,5,-8,-5.033333333333333,183,222,240,645,-35.54364972360261
219,2021-10-04,1611.68994140625,1619.6199951171875,1610.9599609375,1614.47998046875,49,33,12,12,28,8,1,1,3.0927835051546393,0.8602524005816004,0.8999212073884976,25,11,14,-5.041666666666667,288,203,157,648,-34.74230281823322
220,2021-10-05,1612.5,1626.43994140625,1611.4200439453125,1624.239990234375,32,23,8,8,36,8,1,1,-0.5891016200294551,0.8614308517600514,0.8982357864215352,15,7,8,-5.091666666666667,215,206,230,651,-35.0114937692623
221,2021-10-06,1626.6500244140625,1631.81005859375,1617.239990234375,1619.47998046875,43,32,12,11,18,4,0,0,3.681885125184094,0.8672279532093268,0.896743602169549,28,12,16,-5.0,203,210,235,648,-35.40092767607129
222,2021-10-07,1627.1500244140625,1637.8199462890625,1624.5899658203125,1633.719970703125,30,25,10,8,9,2,0,0,3.0927835051546393,0.8755612865426602,0.8955291956953405,23,10,13,-4.85,319,198,129,646,-34.42380236714376
223,2021-10-08,1641.9200439453125,1644.1600341796875,1635.77001953125,1639.4100341796875,52,33,12,12,6,0,0,0,6.774668630338733,0.8777835087648823,0.8943888632952058,33,12,21,-4.683333333333334,273,178,195,646,-33.76368556691509
224,2021-10-11,1644.3800048828125,1646.5,1629.949951171875,1633.43994140625,53,37,14,14,10,1,0,0,6.332842415316642,0.8827835087648824,0.893415197561738,36,14,22,-4.516666666666667,193,194,262,649,-34.35853525704375
225,2021-10-12,1644.56005859375,1646.8499755859375,1637.489990234375,1643.6400146484375,60,41,13,12,19,3,1,1,6.0382916053019144,0.8815930325744062,0.892421690558429,38,12,26,-4.191666666666666,245,194,211,650,-33.940972118873034
226,2021-10-14,1647.56005859375,1648.6199951171875,1637.4200439453125,1640.969970703125,56,33,14,13,18,4,0,0,5.596465390279823,0.8815930325744062,0.89142818355512,29,14,15,-3.875,215,189,241,645,-34.31089387446894
227,2021-10-15,1646.3499755859375,1651.4100341796875,1635.1400146484375,1638.3399658203125,50,27,3,3,22,9,1,1,4.123711340206185,0.8774263659077396,0.8903652321073664,18,2,16,-3.7416666666666667,175,194,277,646,-35.03413444514852
228,2021-10-18,1641.969970703125,1648.0,1639.9200439453125,1643.9200439453125,56,27,6,6,26,10,1,0,4.418262150220913,0.8780757165570903,0.8893636082209404,17,5,12,-3.6666666666666665,271,191,185,647,-34.36486867830647
229,2021-10-19,1648.47998046875,1649.6600341796875,1627.1199951171875,1630.3900146484375,46,27,10,10,24,4,0,0,3.240058910162003,0.8822423832237569,0.8885008732234033,23,10,13,-3.5833333333333335,135,170,344,649,-35.4704102750916
230,2021-10-20,1633.8800048828125,1639.4100341796875,1632.6199951171875,1637.550048828125,35,19,8,8,12,2,0,0,3.3873343151693667,0.8843257165570902,0.8877075826703108,17,8,9,-3.533333333333333,290,227,133,650,-34.64059313184372
231,2021-10-21,1644.3900146484375,1646.5,1639.1600341796875,1643.4200439453125,67,34,10,10,7,2,0,0,8.836524300441827,0.8843257165570902,0.8869050328579589,32,10,22,-3.316666666666667,289,196,165,650,-33.84721956008482
232,2021-10-25,1645.0,1645.9100341796875,1631.2900390625,1634.199951171875,54,21,12,12,20,2,0,0,5.007363770250368,0.8867066689380427,0.8861725888657127,19,12,7,-3.2,183,174,294,651,-34.64364012378575
233,2021-10-26,1635.6099853515625,1639.9300537109375,1627.6800537109375,1635.969970703125,42,17,6,5,8,2,0,0,5.007363770250368,0.889087621318995,0.8855159486992704,15,6,9,-3.1083333333333334,198,201,248,647,-35.14115871889074
234,2021-10-27,1632.43994140625,1635.6800537109375,1626.56005859375,1627.6099853515625,43,25,12,12,20,2,0,0,3.3873343151693667,0.894087621318995,0.8850212671015665,23,12,11,-3.025,167,197,279,643,-35.893260151981096
235,2021-10-28,1626.06005859375,1632.300048828125,1622.56005859375,1624.31005859375,45,21,12,12,38,10,3,3,1.0309278350515463,0.9008992155218934,0.8848091941995146,11,9,2,-3.075,162,188,295,645,-36.73213064478896
236,2021-10-29,1626.27001953125,1629.25,1619.1400146484375,1623.4300537109375,36,23,11,10,39,8,1,0,-0.4418262150220913,0.9090341361568142,0.884891433466775,15,10,5,-3.058333333333333,230,186,229,645,-36.65900340237625
237,2021-11-01,1627.5899658203125,1632.72998046875,1611.3900146484375,1613.780029296875,40,25,13,13,73,19,7,6,-4.860088365243004,0.9071690567917349,0.8849986246339873,6,6,0,-3.066666666666667,129,176,342,647,-37.755994665107394
238,2021-11-02,1616.739990234375,1621.68994140625,1608.6400146484375,1617.8900146484375,20,13,7,7,122,28,11,7,-15.022091310751104,0.8989446559202751,0.8850014221919039,-15,-4,-11,-3.125,145,160,344,649,-38.86776120747162
239,2021-11-03,1620.52001953125,1623.0799560546875,1607.719970703125,1611.9200439453125,16,6,2,2,127,29,9,7,-16.347569955817377,0.8853082922839114,0.8847651266915785,-23,-7,-16,-3.2666666666666666,112,141,398,651,-40.28694565885285
240,2021-11-04,1613.449951171875,1627.5699462890625,1607.72998046875,1626.27001953125,19,10,4,2,83,21,9,5,-9.425625920471282,0.8768001337757529,0.8844257132689862,-11,-5,-6,-3.308333333333333,383,162,105,650,-38.98098950629924
241,2021-11-05,1627.449951171875,1628.5999755859375,1619.6199951171875,1626.219970703125,13,8,6,5,33,9,3,2,-2.9455081001472756,0.8743695782201975,0.8840480163706107,-1,3,-4,-3.275,194,216,238,648,-39.43128382889117
242,2021-11-08,1631.3399658203125,1635.6199951171875,1621.3499755859375,1626.1300048828125,33,17,10,9,50,18,3,2,-2.503681885125184,0.8705234243740436,0.8835630070315893,-1,7,-8,-3.2,210,175,262,647,-39.97484113539578
243,2021-11-09,1626.800048828125,1633.760009765625,1623.6400146484375,1631.68994140625,28,19,11,11,27,9,1,1,0.14727540500736377,0.8709863873370065,0.8830213398442432,10,10,0,-2.658333333333333,309,192,148,649,-39.06149733857461
244,2021-11-10,1627.6700439453125,1633.4300537109375,1625.1300048828125,1630.469970703125,30,17,9,9,20,10,1,1,1.4727540500736378,0.8793197206703399,0.8827587731859978,7,8,-1,-2.6666666666666665,265,204,186,655,-38.44071891300029
245,2021-11-11,1629.280029296875,1634.43994140625,1626.800048828125,1632.43994140625,48,23,9,8,23,8,3,2,3.681885125184094,0.8869177598860262,0.8827806047698078,15,6,9,-2.466666666666667,237,176,237,650,-38.44071891300029
246,2021-11-12,1636.6300048828125,1640.6600341796875,1632.8800048828125,1633.93994140625,61,39,21,21,23,9,2,0,5.596465390279823,0.8880325870878099,0.882863751849716,30,19,11,-2.4,260,174,213,647,-37.92248013736552
247,2021-11-15,1636.4100341796875,1642.5999755859375,1635.219970703125,1638.72998046875,57,34,16,15,49,17,3,2,1.1782032400589102,0.8854010081404414,0.8828948693458608,17,13,4,-2.3666666666666667,204,165,282,651,-38.60795772129681
248,2021-11-16,1642.050048828125,1648.4300537109375,1639.0799560546875,1644.010009765625,68,47,24,24,31,12,1,1,5.44918998527246,0.8847343414737747,0.8829064582224769,35,23,12,-2.283333333333333,240,182,228,650,-38.35188396143102
249,2021-11-17,1646.8599853515625,1651.510009765625,1642.3599853515625,1644.5999755859375,60,31,11,11,25,7,3,3,5.154639175257732,0.8811629129023462,0.8828411621784582,24,8,16,-2.15,211,194,247,652,-38.78155288585468
250,2021-11-18,1643.3900146484375,1653.6800537109375,1642.5,1651.02001953125,62,39,18,17,28,12,0,0,5.007363770250368,0.8811629129023462,0.882731421689995,27,18,9,-2.075,306,210,136,652,-37.883952081604
251,2021-11-19,1653.3599853515625,1656.27001953125,1641.52001953125,1645.06005859375,56,34,17,17,16,5,2,2,5.891016200294551,0.8794085269374339,0.8825659864089949,29,15,14,-1.9916666666666667,196,185,270,651,-38.514705173047545
252,2021-11-22,1648.1400146484375,1653.3299560546875,1645.0899658203125,1649.5400390625,62,38,18,17,28,7,0,0,5.007363770250368,0.8794085269374339,0.8823842112587137,31,18,13,-1.9,242,187,222,651,-38.188541136520826
253,2021-11-23,1652.6199951171875,1654.489990234375,1644.02001953125,1646.4200439453125,62,34,18,17,20,6,1,1,6.185567010309279,0.8785313339549777,0.8821878162253916,28,17,11,-1.8083333333333333,212,174,263,649,-38.728382383026286
254,2021-11-24,1650.5400390625,1658.5999755859375,1647.9000244140625,1649.8199462890625,66,37,21,21,13,6,0,0,7.80559646539028,0.8785313339549777,0.8819824606185929,31,21,10,-1.7083333333333333,286,195,170,651,-37.95907312486421
255,2021-11-25,1654.93994140625,1656.4599609375,1644.8699951171875,1648.4599609375,52,28,17,17,24,6,2,2,4.123711340206185,0.8767769479900654,0.8817332453626713,22,15,7,-1.6666666666666667,208,180,267,655,-38.530008191950415
256,2021-11-26,1639.5400390625,1640.9100341796875,1608.550048828125,1610.6099853515625,38,22,10,10,90,37,3,2,-7.658321060382916,0.8729307941439116,0.8814199275426471,-15,7,-22,-1.8666666666666667,81,109,465,655,-40.39840565793807
257,2021-11-29,1608.010009765625,1617.550048828125,1587.780029296875,1589.68994140625,24,18,14,12,176,95,12,8,-22.38586156111929,0.865238486451604,0.8809784045944178,-77,2,-79,-2.525,100,118,440,658,-42.0887141673951
258,2021-11-30,1601.52001953125,1612.0999755859375,1565.949951171875,1568.68994140625,16,12,7,7,219,139,26,19,-29.896907216494846,0.8521071733202908,0.8803180264273334,-127,-19,-108,-3.4583333333333335,95,124,438,657,-43.745216506663
259,2021-12-01,1576.260009765625,1591.8599853515625,1563.0400390625,1590.81005859375,18,15,10,10,119,89,20,15,-14.874815905743741,0.8419219881351057,0.8795033272725945,-74,-10,-64,-3.9916666666666667,403,158,95,656,-42.353416622254684
260,2021-12-02,1583.3800048828125,1592.0,1580.0799560546875,1591.8399658203125,35,23,12,12,18,13,6,3,2.503681885125184,0.8363664325795501,0.8785960355252631,10,6,4,-3.975,215,191,247,653,-42.761664912718544
261,2021-12-03,1593.0799560546875,1597.25,1587.530029296875,1588.18994140625,27,21,12,12,25,17,8,5,0.29455081001472755,0.832263868476986,0.8776631027522906,4,4,0,-4.016666666666667,223,205,224,652,-42.831338214147706
262,2021-12-07,1600.1700439453125,1611.5799560546875,1595.1400146484375,1609.280029296875,32,23,15,14,7,2,0,0,3.681885125184094,0.8332442606338488,0.876753271173819,21,15,6,-4.016666666666667,373,170,107,650,-41.58411908522306
263,2021-12-08,1617.0899658203125,1621.2099609375,1610.300048828125,1618.3599853515625,41,33,27,26,12,5,1,1,4.270986745213549,0.8335262155210669,0.8758627587265087,28,26,2,-3.9833333333333334,276,199,172,647,-40.86300883013026
264,2021-12-09,1621.6300048828125,1623.8199462890625,1612.5699462890625,1618.22998046875,49,31,20,20,9,2,0,0,5.891016200294551,0.8335262155210669,0.8749722462791981,29,20,9,-3.9,240,186,225,651,-40.57978823811175
265,2021-12-13,1626.260009765625,1628.9300537109375,1618.5699462890625,1625.8299560546875,50,35,22,22,11,4,2,2,5.743740795287187,0.8342206599655113,0.8741280301281841,31,20,11,-3.8833333333333333,257,178,216,651,-40.10119626228097
266,2021-12-14,1619.68994140625,1630.9300537109375,1616.510009765625,1630.6400146484375,54,34,21,21,7,5,2,2,6.9219440353460975,0.8361047179365256,0.8733707704989091,29,19,10,-3.808333333333333,225,209,215,649,-39.88297837204498
267,2021-12-15,1628.010009765625,1630.8900146484375,1622.489990234375,1623.6600341796875,64,40,27,27,13,6,1,1,7.511045655375552,0.8366205909523987,0.8726406272717505,34,26,8,-3.8,207,198,246,651,-40.32567454268291
268,2021-12-16,1629.47998046875,1645.43994140625,1624.31005859375,1645.3199462890625,51,29,23,23,15,7,0,0,5.3019145802650955,0.8384724428042506,0.8719722124396536,22,23,-1,-3.7916666666666665,299,184,169,652,-39.487400898398
269,2021-12-17,1644.0999755859375,1646.8499755859375,1637.0899658203125,1641.72998046875,43,26,16,16,6,3,0,0,5.44918998527246,0.8384724428042506,0.8713037976075567,23,16,7,-3.75,199,193,262,654,-40.05726252023372
270,2021-12-20,1631.219970703125,1633.800048828125,1612.9599609375,1615.800048828125,31,24,20,20,29,19,6,4,0.29455081001472755,0.8362929556247634,0.8706083172483944,5,14,-9,-3.783333333333333,88,119,441,648,-41.772391281192114
271,2021-12-21,1623.199951171875,1628.8399658203125,1618.5699462890625,1622.25,26,20,14,14,25,13,5,4,0.14727540500736377,0.8337588425643346,0.8698706016715582,7,9,-2,-3.683333333333333,236,211,202,649,-41.3719198608753
272,2021-12-22,1628.4200439453125,1632.3299560546875,1624.77001953125,1626.7900390625,41,25,16,16,16,10,3,3,3.681885125184094,0.8311272636169662,0.8690676589242317,15,13,2,-3.6333333333333333,252,211,187,650,-40.81820172537231
273,2021-12-23,1633.199951171875,1645.7099609375,1632.9000244140625,1641.469970703125,39,22,14,14,16,8,0,0,3.3873343151693667,0.8335082159979185,0.8683255627377517,14,14,0,-3.45,271,205,173,649,-40.128471230657304
274,2021-12-24,1642.6400146484375,1644.1199951171875,1635.18994140625,1637.219970703125,28,20,16,15,22,18,2,2,0.8836524300441826,0.8349896974794001,0.867663713464852,2,14,-12,-3.5083333333333333,162,216,273,651,-40.84367801007651
275,2021-12-27,1641.280029296875,1642.4200439453125,1632.7900390625,1636.5,41,28,19,18,37,23,6,6,0.5891016200294551,0.8335538000435025,0.8670206676107557,5,13,-8,-3.558333333333333,197,190,261,648,-41.42253769431045
276,2021-12-28,1640.969970703125,1650.280029296875,1640.6099853515625,1641.52001953125,35,17,12,11,31,20,6,4,0.5891016200294551,0.8317019481916507,0.8664084859541903,-3,6,-9,-3.6166666666666667,215,188,248,651,-41.84039314132912
277,2021-12-29,1643.4300537109375,1654.97998046875,1641.75,1653.3299560546875,44,19,8,8,22,10,2,2,3.240058910162003,0.8317019481916508,0.8658518598531805,9,6,3,-3.525,293,208,151,652,-41.01612022698547
278,2021-12-30,1657.2900390625,1660.8499755859375,1652.3699951171875,1657.6199951171875,59,28,16,15,11,8,1,1,7.069219440353461,0.8352670105802424,0.8654140691651235,20,15,5,-3.341666666666667,289,197,167,653,-40.231160599895254
279,2022-01-04,1664.510009765625,1674.18994140625,1663.5,1670.280029296875,97,44,25,23,11,3,2,2,12.665684830633284,0.8353144939610592,0.8649984373881145,41,23,18,-3.175,365,150,139,654,-39.00776829089464
280,2022-01-05,1672.8900146484375,1677.949951171875,1670.5899658203125,1676.7900390625,108,44,29,28,11,5,3,2,14.285714285714286,0.835603845812911,0.8645679872889956,39,26,13,-2.95,295,179,179,653,-38.20499531897515
281,2022-01-06,1663.5899658203125,1666.219970703125,1653.030029296875,1653.030029296875,52,27,16,14,19,9,3,2,4.860088365243004,0.8329722668655427,0.8639970591832659,18,13,5,-2.35,143,151,361,655,-39.40258060876281
282,2022-01-07,1659.1500244140625,1662.4200439453125,1650.530029296875,1657.6199951171875,62,25,13,13,19,9,5,3,6.332842415316642,0.8283426372359131,0.86321008169482,16,8,8,-1.7666666666666666,210,183,260,653,-39.9238666439055
283,2022-01-10,1661.5,1664.22998046875,1654.050048828125,1657.06005859375,80,42,22,21,30,14,4,2,7.363770250368188,0.8257785346718105,0.8623433321266022,28,18,10,-1.5833333333333333,244,179,229,652,-39.63519150931069
284,2022-01-11,1659.3299560546875,1667.699951171875,1659.0,1667.1199951171875,78,42,18,18,28,12,3,2,7.363770250368188,0.823397582290858,0.8613535666853684,30,15,15,-1.4166666666666667,264,191,199,654,-39.05334817415365
285,2022-01-12,1676.030029296875,1680.8499755859375,1673.0,1678.5,94,44,28,28,17,9,5,2,11.34020618556701,0.8220628059560817,0.8603613962417298,35,23,12,-1.3166666666666667,300,190,165,655,-38.212630455342804
286,2022-01-13,1680.8299560546875,1682.7099609375,1675.739990234375,1680.02001953125,102,59,31,31,9,6,1,1,13.69661266568483,0.8215419726227484,0.8593605452425355,53,30,23,-1.1333333333333333,265,191,198,654,-37.62190350206123
287,2022-01-14,1676.5799560546875,1680.02001953125,1670.699951171875,1672.6300048828125,81,52,33,33,13,4,1,1,10.014727540500736,0.8252184432109837,0.8584904131975896,48,32,16,-1.0083333333333333,172,193,287,652,-38.39182785234159
288,2022-01-17,1675.81005859375,1680.3900146484375,1672.9300537109375,1676.8699951171875,74,38,29,27,14,4,1,1,8.836524300441827,0.8270438400363804,0.8576398819222443,34,28,6,-0.925,239,193,217,649,-38.05507562613415
289,2022-01-18,1680.280029296875,1682.9300537109375,1660.1500244140625,1660.27001953125,57,33,22,22,40,15,3,2,2.503681885125184,0.8250438400363805,0.8566865728691214,18,19,-1,-0.7,98,142,409,649,-39.529804474033035
290,2022-01-19,1658.8599853515625,1667.43994140625,1653.3800048828125,1658.239990234375,32,19,10,9,75,34,9,5,-6.332842415316642,0.8171491031942753,0.8555669626464079,-15,1,-16,-0.6666666666666666,192,166,292,650,-40.30362770656717
291,2022-01-20,1663.31005859375,1666.5999755859375,1656.469970703125,1656.9599609375,40,19,9,7,43,20,6,4,-0.4418262150220913,0.8104824365276085,0.854336241312583,-1,3,-4,-0.675,184,168,298,650,-41.12494141826188
292,2022-01-21,1651.2099609375,1655.4200439453125,1641.8599853515625,1652.72998046875,18,11,8,8,88,37,12,9,-10.309278350515465,0.8004824365276086,0.8528991707724092,-26,-4,-22,-0.75,167,175,312,654,-42.032610761339875
293,2022-01-24,1650.3399658203125,1654.989990234375,1639.1400146484375,1640.5400390625,26,13,7,7,92,38,11,6,-9.720176730486008,0.7902972513424233,0.851252664606133,-25,-4,-21,-0.7666666666666667,112,143,400,655,-43.44682432371297
294,2022-01-25,1636.3299560546875,1641.6800537109375,1624.2900390625,1639.0899658203125,18,13,6,6,167,74,31,19,-21.944035346097202,0.7763332873784594,0.8492900923737907,-61,-25,-36,-0.8416666666666667,166,149,332,647,-44.4988065795836
295,2022-01-26,1645.489990234375,1649.8199462890625,1642.0699462890625,1643.43994140625,24,18,13,13,47,24,17,11,-3.3873343151693667,0.7702221762673483,0.8471121417195484,-6,-4,-2,-0.3,235,179,236,650,-44.57334217883359
296,2022-01-27,1633.780029296875,1635.1400146484375,1617.8699951171875,1634.1700439453125,15,7,5,5,166,82,27,19,-22.23858615611193,0.7575485651562374,0.8445873822028721,-75,-22,-53,-0.15833333333333333,141,148,366,655,-45.80219005961215
297,2022-01-28,1637.8199462890625,1646.47998046875,1636.699951171875,1639.510009765625,27,16,8,8,29,14,8,5,-0.29455081001472755,0.7550485651562372,0.8420520406756137,2,0,2,-0.016666666666666666,346,168,141,655,-44.70081920859089
298,2022-01-31,1647.6800537109375,1655.47998046875,1646.8800048828125,1648.81005859375,35,17,8,8,19,11,3,2,2.3564064801178204,0.7606882957959679,0.8397477680068752,6,5,1,-0.025,379,156,115,650,-43.404081508660646
299,2022-02-01,1659.4300537109375,1663.760009765625,1658.260009765625,1661.75,21,11,5,4,9,4,3,2,1.7673048600883652,0.7680746594323316,0.8377938741260157,7,2,5,0.03333333333333333,351,160,134,645,-42.24312238493728
300,2022-02-02,1665.800048828125,1669.5,1658.5799560546875,1667.75,33,22,9,9,6,4,2,2,3.976435935198822,0.77658281794049,0.8361235855287613,18,7,11,0.275,250,206,189,645,-41.7002725066669
301,2022-02-03,1664.6300048828125,1673.75,1664.0899658203125,1669.050048828125,37,29,14,12,10,1,1,1,3.976435935198822,0.7810272623849345,0.8345678802648402,28,13,15,0.475,188,193,266,647,-42.33435598356099
302,2022-02-04,1672.9000244140625,1678.719970703125,1672.3900146484375,1674.219970703125,37,18,8,7,10,2,1,1,3.976435935198822,0.7830215643792364,0.8331095159315933,16,7,9,0.5166666666666667,201,205,245,651,-42.79651638105271
303,2022-02-07,1679.0799560546875,1681.1700439453125,1667.2900390625,1677.239990234375,37,24,11,10,11,2,0,0,3.829160530191458,0.7844104532681253,0.831666583697112,22,11,11,0.6583333333333333,194,198,257,649,-43.359173394314666
304,2022-02-08,1680.6099853515625,1685.1400146484375,1677.47998046875,1684.22998046875,40,18,10,10,14,3,2,1,3.829160530191458,0.7832993421570141,0.8300662440552232,15,8,7,1.0833333333333333,235,195,221,651,-43.091912152402244
305,2022-02-09,1689.52001953125,1708.030029296875,1688.949951171875,1703.1600341796875,59,29,16,16,25,9,1,1,5.007363770250368,0.786485616666818,0.8283923750015698,20,15,5,1.9416666666666667,194,171,290,655,-43.83899952003987
306,2022-02-10,1705.72998046875,1707.43994140625,1696.72998046875,1703.0,41,25,12,10,39,15,4,3,0.29455081001472755,0.7837682253624703,0.8266546356394807,10,8,2,2.033333333333333,175,167,308,650,-44.72875604104248
307,2022-02-11,1694.7099609375,1703.949951171875,1690.68994140625,1699.199951171875,28,16,10,10,50,19,5,4,-3.240058910162003,0.7808442487542832,0.8249120229830448,-3,5,-8,2.025,172,186,293,651,-45.533155707582324
308,2022-02-14,1692.8900146484375,1694.18994140625,1680.8299560546875,1684.68994140625,21,14,7,7,77,42,9,8,-8.24742268041237,0.77213591542095,0.823035382548831,-28,-2,-26,1.8583333333333334,119,149,387,655,-46.869818217966554
309,2022-02-15,1688.6700439453125,1702.739990234375,1687.1800537109375,1701.449951171875,26,17,10,9,34,20,9,6,-1.1782032400589102,0.7678126071502731,0.8211462107862965,-3,1,-4,1.8166666666666667,339,163,151,653,-45.79914484881299
310,2022-02-17,1709.5,1718.550048828125,1708.4300537109375,1711.5799560546875,65,34,19,16,15,11,5,5,7.363770250368188,0.7643403849280509,0.8191991686533916,23,14,9,1.8583333333333334,329,166,153,648,-44.772552322262726
311,2022-02-18,1709.030029296875,1716.1400146484375,1703.5999755859375,1713.199951171875,52,23,10,10,16,10,4,2,5.3019145802650955,0.7613328661310584,0.8172312409732854,13,6,7,1.925,218,183,250,651,-45.189581150376874
312,2022-02-21,1712.949951171875,1713.8699951171875,1692.1300048828125,1694.3199462890625,60,31,12,12,39,21,6,4,3.0927835051546393,0.7557773105755029,0.8151707207005866,10,6,4,1.9166666666666667,171,157,328,656,-46.1864115702959
313,2022-02-22,1681.239990234375,1691.6199951171875,1673.31005859375,1691.1199951171875,28,12,5,4,58,35,8,8,-4.418262150220913,0.7463980933015488,0.8129685000230295,-23,-3,-20,1.7083333333333333,219,168,265,652,-46.70812926130554
314,2022-02-23,1694.0699462890625,1700.3499755859375,1686.0899658203125,1696.449951171875,49,23,12,12,16,8,4,4,4.860088365243004,0.7422314266348822,0.8106968349010278,15,8,7,1.725,323,164,165,652,-45.72957126221925
315,2022-02-24,1683.9200439453125,1690.5,1656.6199951171875,1662.719970703125,33,18,8,8,151,87,31,24,-17.378497790868924,0.7307379493519311,0.8082628515903921,-69,-23,-46,1.2416666666666667,51,76,528,655,-48.21850782123501
316,2022-02-25,1676.1199951171875,1684.5,1670.1300048828125,1679.9000244140625,44,23,11,11,38,19,11,6,0.8836524300441826,0.7262507698647517,0.8058181845190728,4,0,4,1.1916666666666667,454,110,87,651,-46.4001826835585
317,2022-02-28,1678.050048828125,1690.6099853515625,1668.050048828125,1685.1800537109375,41,25,14,11,44,24,7,6,-0.4418262150220913,0.7283875220015037,0.8035373351115712,1,7,-6,1.0416666666666667,225,155,266,646,-46.91284291492086
318,2022-03-01,1694.949951171875,1701.68994140625,1690.8199462890625,1694.280029296875,48,30,19,17,28,17,9,7,2.9455081001472756,0.7361616922756741,0.8016049104274943,13,10,3,0.9833333333333333,334,165,158,657,-45.88316288507886
319,2022-03-02,1694.6400146484375,1699.5799560546875,1684.530029296875,1689.81005859375,37,32,17,14,44,27,17,13,-1.0309278350515463,0.7389394700534518,0.7998885351261333,5,0,5,0.9666666666666667,149,163,348,660,-46.98471389803575
320,2022-03-03,1701.260009765625,1705.5,1691.199951171875,1696.0799560546875,59,45,22,18,40,32,20,15,2.7982326951399115,0.7365585176724995,0.7982250698776825,13,2,11,0.975,283,170,200,653,-46.28802162955628
321,2022-03-04,1687.989990234375,1689.8900146484375,1671.699951171875,1671.719970703125,34,26,8,6,60,40,20,17,-3.829160530191458,0.7313204224344042,0.7965426791103061,-14,-12,-2,0.8583333333333333,104,129,419,652,-47.8446451945446
322,2022-03-07,1654.4300537109375,1655.18994140625,1616.0799560546875,1626.699951171875,13,8,2,2,271,167,78,57,-37.99705449189985,0.7150704224344042,0.7945731151403154,-159,-76,-83,0.11666666666666667,38,72,543,653,-50.474817854120026
323,2022-03-08,1622.030029296875,1633.5,1580.800048828125,1619.0999755859375,7,4,2,2,396,280,123,88,-57.29013254786451,0.6992656605296422,0.7923354392237916,-276,-121,-155,-1.1916666666666667,118,119,418,655,-52.05595668420422
324,2022-03-09,1626.719970703125,1643.8699951171875,1610.3399658203125,1643.6400146484375,12,9,3,2,33,23,13,9,-3.0927835051546393,0.6857239938629756,0.7898720688628236,-14,-10,-4,-1.2916666666666667,470,100,82,652,-50.09596072542883
325,2022-03-10,1652.989990234375,1659.2900390625,1643.3900146484375,1647.0799560546875,18,13,6,4,13,3,0,0,0.7363770250368189,0.6871128827518646,0.7874202725759293,10,6,4,-1.3583333333333334,302,160,186,648,-49.247139840665774
326,2022-03-11,1642.27001953125,1659.6700439453125,1637.9300537109375,1658.010009765625,24,13,6,5,13,4,3,2,1.6200294550810015,0.6830066025586279,0.7848686373196311,9,3,6,-1.3666666666666667,342,180,121,643,-48.14215365290679
327,2022-03-14,1656.3599853515625,1662.6600341796875,1651.9000244140625,1660.1500244140625,34,16,8,7,8,2,1,0,3.829160530191458,0.6817499888020141,0.7822874606171247,14,7,7,-1.3583333333333334,246,180,222,648,-47.77801537548615
328,2022-03-15,1656.780029296875,1663.3199462890625,1639.9000244140625,1644.3599853515625,23,14,7,6,11,6,1,0,1.7673048600883652,0.6796666554686808,0.7796406974948652,8,6,2,-1.3916666666666666,114,142,397,653,-49.184792180463035
329,2022-03-16,1655.010009765625,1668.949951171875,1653.8699951171875,1667.9200439453125,18,9,5,5,10,3,2,2,1.1782032400589102,0.674904750706776,0.7769145692932405,6,3,3,-1.375,419,146,85,650,-47.67744058128738
330,2022-03-17,1679.27001953125,1686.449951171875,1677.18994140625,1681.760009765625,29,16,7,7,2,0,0,0,3.976435935198822,0.6787509045529299,0.7742888684420435,16,7,9,-1.3,316,188,147,651,-46.731829723598075
331,2022-03-18,1684.1199951171875,1685.6800537109375,1677.1600341796875,1678.510009765625,28,13,8,8,6,3,2,1,3.240058910162003,0.6798035361318772,0.771722946668169,10,6,4,-1.225,212,196,239,647,-47.10204025500345
332,2022-03-21,1683.68994140625,1685.780029296875,1671.0799560546875,1673.8699951171875,38,25,16,15,11,6,3,1,3.976435935198822,0.6798035361318772,0.7692008845434176,19,13,6,-1.2583333333333333,191,178,278,647,-47.79920129777124
333,2022-03-22,1672.989990234375,1680.0,1670.550048828125,1677.8699951171875,32,12,5,5,6,2,2,0,3.829160530191458,0.6750416313699724,0.7665597747996185,10,3,7,-1.2833333333333334,234,185,230,649,-47.65255418274989
334,2022-03-23,1684.030029296875,1686.1400146484375,1676.8800048828125,1677.949951171875,45,18,5,5,6,2,1,0,5.743740795287187,0.6741157054440465,0.7638785415990292,16,4,12,-1.2166666666666666,239,204,207,650,-47.25746234409005
335,2022-03-24,1677.52001953125,1685.1199951171875,1675.18994140625,1680.8900146484375,38,20,7,7,9,3,2,1,4.270986745213549,0.6744120017403428,0.7612261782939768,17,5,12,-1.1333333333333333,204,190,256,650,-47.77923941229114
336,2022-03-25,1683.6700439453125,1685.4100341796875,1674.1199951171875,1676.800048828125,34,15,10,9,10,3,3,3,3.5346097201767304,0.6761214034497446,0.758633169214945,12,7,5,-1.0833333333333333,163,189,299,651,-48.62528283533999
337,2022-03-28,1678.1300048828125,1687.199951171875,1676.75,1684.300048828125,41,19,9,9,19,6,2,2,3.240058910162003,0.6764244337527748,0.7560452106409634,13,7,6,-1.05,292,202,154,648,-47.80078119455022
338,2022-03-29,1688.52001953125,1692.9000244140625,1686.8399658203125,1689.739990234375,50,19,9,7,11,4,2,2,5.743740795287187,0.6743745228793345,0.7533636691792818,15,7,8,-0.9166666666666666,247,189,210,646,-47.359491219471174
339,2022-03-30,1694.8399658203125,1702.6700439453125,1692.72998046875,1698.4000244140625,63,27,13,12,7,3,2,2,8.24742268041237,0.673386868558347,0.75066487542257,24,11,13,-0.925,278,203,166,647,-46.618532645836225
340,2022-03-31,1698.800048828125,1701.949951171875,1693.1600341796875,1695.239990234375,69,21,12,10,10,5,2,2,8.689248895434462,0.6725684161773946,0.747947618261978,16,10,6,-0.9416666666666667,217,185,250,652,-47.03974441542334
341,2022-04-01,1693.6700439453125,1701.989990234375,1690.699951171875,1701.31005859375,54,11,7,7,10,4,3,3,6.480117820324006,0.6701999951247629,0.7452347470662982,7,4,3,-1.05,238,206,212,656,-46.68533806004255
342,2022-04-04,1704.6400146484375,1706.77001953125,1699.8199462890625,1702.9300537109375,60,20,11,10,15,7,3,3,6.62739322533137,0.6712581961829639,0.7426166730487491,13,8,5,-1.1166666666666667,218,182,255,655,-47.13498880489874
343,2022-04-05,1705.8599853515625,1708.8900146484375,1698.3299560546875,1701.1800537109375,48,19,10,9,19,10,6,4,4.270986745213549,0.6675722987470665,0.7399799024500034,9,4,5,-1.25,141,199,313,653,-48.06235065444831
344,2022-04-07,1693.4599609375,1694.22998046875,1674.81005859375,1682.4100341796875,20,12,7,7,40,15,4,3,-2.9455081001472756,0.663892645067413,0.7373214868296127,-3,3,-6,-1.4833333333333334,118,157,376,651,-49.34020486851385
345,2022-04-08,1684.6600341796875,1690.5799560546875,1678.0699462890625,1686.0,34,15,11,11,38,11,3,3,-0.5891016200294551,0.6628464690212368,0.7346678812140318,4,8,-4,-1.7333333333333334,237,193,218,648,-49.02725416260333
346,2022-04-11,1683.449951171875,1685.949951171875,1675.949951171875,1678.4599609375,34,22,13,12,71,16,4,4,-5.44918998527246,0.6594457337271192,0.731966277232438,6,9,-3,-1.8833333333333333,126,127,395,648,-50.47693085069623
347,2022-04-12,1673.719970703125,1678.43994140625,1669.3599853515625,1674.3399658203125,28,18,12,12,101,25,6,5,-10.751104565537556,0.654380374249995,0.7291189760830882,-7,6,-13,-2.125,219,218,212,649,-50.29814754521265
348,2022-04-18,1669.0899658203125,1675.949951171875,1665.25,1668.06005859375,42,26,11,11,61,17,10,7,-2.7982326951399115,0.6469994218690426,0.7261182357802994,9,1,8,-2.158333333333333,263,173,210,646,-49.74624383880235
349,2022-04-19,1675.260009765625,1681.75,1673.9100341796875,1675.6199951171875,46,24,19,19,28,7,0,0,2.6509572901325478,0.6489994218690426,0.723184162144177,17,19,-2,-2.283333333333333,306,168,173,647,-48.859123639212285
350,2022-04-20,1678.5,1685.9000244140625,1675.5799560546875,1680.3499755859375,48,26,17,17,11,5,2,2,5.44918998527246,0.6551397727462355,0.7204840066367096,21,15,6,-2.308333333333333,261,183,200,644,-48.28334439407537
351,2022-04-21,1686.31005859375,1693.969970703125,1682.6500244140625,1690.550048828125,61,32,15,15,19,7,2,2,6.185567010309279,0.6598456550991768,0.7179733936129025,25,13,12,-2.3916666666666666,270,193,188,651,-47.63320563014021
352,2022-04-22,1686.260009765625,1690.5899658203125,1680.8599853515625,1690.5899658203125,56,28,18,17,26,9,2,1,4.418262150220913,0.6681789884325101,0.7157683361446507,19,16,3,-2.425,211,185,255,651,-48.11957908725413
353,2022-04-25,1677.550048828125,1683.06005859375,1672.989990234375,1675.3299560546875,57,27,16,16,60,17,6,5,-0.4418262150220913,0.6738187190722408,0.7138270272734811,10,10,0,-2.5,142,160,349,651,-49.25347250628181
354,2022-04-26,1681.739990234375,1685.4200439453125,1668.760009765625,1668.969970703125,53,29,14,14,52,13,6,5,0.14727540500736377,0.6827826830362047,0.7122678505344435,16,8,8,-2.525,164,165,322,651,-50.22907858914295
355,2022-04-27,1667.449951171875,1670.219970703125,1655.25,1661.8900146484375,24,11,7,7,138,48,21,19,-16.78939617083947,0.6797271274806491,0.710759599721332,-37,-14,-23,-2.7333333333333334,132,154,366,652,-51.45776789867357
356,2022-04-28,1663.1400146484375,1669.0400390625,1658.469970703125,1667.739990234375,37,23,11,10,51,20,11,9,-2.0618556701030926,0.6854562941473158,0.7095580618711832,3,0,3,-2.75,349,168,139,656,-50.343046610505155
357,2022-04-29,1667.81005859375,1673.5400390625,1666.8399658203125,1667.43994140625,42,25,8,8,30,13,4,3,1.7673048600883652,0.6882340719250936,0.7084444869839975,12,4,8,-2.683333333333333,233,191,231,655,-50.24098453788919
358,2022-05-03,1667.4100341796875,1668.5400390625,1649.5,1652.2900390625,26,12,5,3,119,37,11,6,-13.69661266568483,0.6813211931372148,0.707121701939685,-25,-6,-19,-2.75,90,125,436,651,-51.89810002753732
359,2022-05-05,1663.25,1667.1199951171875,1643.1700439453125,1643.300048828125,16,9,5,4,122,46,19,17,-15.61119293078056,0.6743767486927703,0.7055600700940255,-37,-14,-23,-2.808333333333333,156,184,310,650,-52.81047737953178
360,2022-05-06,1626.0799560546875,1634.6500244140625,1617.93994140625,1629.5799560546875,5,3,0,0,257,107,45,34,-37.11340206185567,0.6607403850564068,0.7036293628792908,-104,-45,-59,-3.25,124,150,376,650,-54.102326508565596
361,2022-05-09,1623.7099609375,1624.260009765625,1604.06005859375,1604.489990234375,11,6,3,2,276,154,73,60,-39.0279823269514,0.6458427242376933,0.7013762872435035,-148,-70,-78,-3.8666666666666667,74,97,482,653,-56.14273463100641
362,2022-05-10,1599.97998046875,1622.8199462890625,1592.6400146484375,1622.780029296875,11,10,5,3,195,124,64,54,-27.098674521354933,0.6322356388914776,0.6988631884853742,-114,-59,-55,-4.258333333333334,404,127,123,654,-54.6610759321152
363,2022-05-11,1621.3499755859375,1622.699951171875,1604.300048828125,1613.3399658203125,17,8,6,4,58,29,14,11,-6.0382916053019144,0.6205689722248109,0.6961324971346523,-21,-8,-13,-4.366666666666666,130,138,379,647,-55.99949548758905
364,2022-05-12,1607.280029296875,1607.8800048828125,1580.0999755859375,1584.52001953125,9,5,3,3,257,161,83,72,-36.52430044182621,0.6072614786847591,0.6931985327434481,-156,-80,-76,-4.991666666666666,70,81,497,648,-58.281450148218994
365,2022-05-13,1592.469970703125,1597.5799560546875,1578.1099853515625,1584.3800048828125,18,9,5,5,160,114,59,49,-20.913107511045656,0.5928772875082886,0.6899717272574726,-105,-54,-51,-5.491666666666666,300,133,219,652,-57.50396856519577
366,2022-05-17,1595.5999755859375,1615.47998046875,1590.9599609375,1614.489990234375,32,16,8,6,57,34,16,14,-3.681885125184094,0.5859328430638442,0.6866744708858288,-18,-8,-10,-5.666666666666667,457,103,90,650,-55.6254462326572
367,2022-05-18,1617.699951171875,1622.1700439453125,1607.31005859375,1620.3299560546875,35,13,7,7,18,11,6,5,2.503681885125184,0.583796090927092,0.6833903349220422,2,1,1,-5.691666666666666,343,159,154,656,-54.53859297669299
368,2022-05-19,1595.4300537109375,1611.6700439453125,1592.0999755859375,1605.97998046875,22,10,6,5,27,13,6,5,-0.7363770250368189,0.5848377575937587,0.6802686989582558,-3,0,-3,-5.816666666666666,113,145,395,653,-55.9283795967592
369,2022-05-20,1618.9200439453125,1626.1600341796875,1616.4599609375,1622.949951171875,32,13,9,7,21,8,3,2,1.6200294550810015,0.5885658277691973,0.6772812526352379,5,6,-1,-5.958333333333333,349,172,131,652,-54.80583088648582
370,2022-05-23,1627.7099609375,1635.3499755859375,1623.5999755859375,1635.280029296875,38,24,13,11,9,7,4,3,4.270986745213549,0.5881164813639684,0.6743441875758365,17,9,8,-5.966666666666667,298,187,168,653,-53.97427249304485
371,2022-05-24,1636.1199951171875,1636.969970703125,1625.9300537109375,1626.22998046875,32,21,12,11,7,5,5,4,3.681885125184094,0.5879764253415595,0.6714549135626782,16,7,9,-6.008333333333334,234,172,247,653,-54.24839748035998
372,2022-05-25,1632.1199951171875,1640.68994140625,1624.030029296875,1625.1800537109375,44,21,12,9,10,5,1,1,5.007363770250368,0.5922499296150637,0.6687294572133375,16,11,5,-6.075,219,188,249,656,-54.64680701680478
373,2022-05-26,1630.530029296875,1636.02001953125,1629.31005859375,1633.72998046875,47,23,12,9,13,6,1,1,5.007363770250368,0.6012242885894228,0.6663098938014687,17,11,6,-6.116666666666666,338,177,142,657,-53.597462652210574
374,2022-05-27,1643.1800537109375,1646.3699951171875,1632.6600341796875,1638.75,40,18,10,10,7,3,1,1,4.860088365243004,0.6038758037409379,0.6640039667532363,15,9,6,-6.15,246,189,221,656,-53.23472452715557
375,2022-05-30,1649.510009765625,1656.5400390625,1646.949951171875,1653.6099853515625,52,23,13,11,5,0,0,0,6.9219440353460975,0.6171236669888012,0.6621103953805175,23,13,10,-6.125,368,183,107,658,-52.04372567708494
376,2022-05-31,1654.27001953125,1663.52001953125,1649.5999755859375,1663.4100341796875,67,22,11,11,1,0,0,0,9.720176730486008,0.6254570003221345,0.6604304992214739,22,11,11,-5.85,286,176,199,661,-51.342636935391845
377,2022-06-01,1662.3199462890625,1664.9000244140625,1655.800048828125,1660.010009765625,73,30,14,13,4,3,2,2,10.1620029455081,0.6289292225443568,0.658772860897188,27,12,15,-5.066666666666666,199,185,277,661,-51.99021306119458
378,2022-06-02,1657.010009765625,1658.050048828125,1645.8900146484375,1647.6700439453125,52,21,11,11,5,4,2,2,6.9219440353460975,0.631722262837397,0.6570322037398834,17,9,8,-4.1,164,190,303,657,-52.843294939503735
379,2022-06-06,1650.4100341796875,1652.1099853515625,1636.0799560546875,1646.0799560546875,40,20,10,9,11,6,2,2,4.270986745213549,0.6372778183929526,0.6553378428788751,14,8,6,-3.5166666666666666,216,175,267,658,-53.381600361427694
380,2022-06-07,1644.219970703125,1645.4100341796875,1630.3699951171875,1631.9200439453125,51,24,11,11,14,7,3,3,5.44918998527246,0.641642897758032,0.6537559158803006,17,8,9,-3.475,143,171,344,658,-54.4626205514162
381,2022-06-08,1639.0999755859375,1641.0799560546875,1631.1199951171875,1636.8900146484375,52,25,11,10,12,5,1,0,5.891016200294551,0.6521587707739049,0.6524365550192924,20,10,10,-3.3916666666666666,311,190,158,659,-53.567608193725626
382,2022-06-09,1637.530029296875,1646.43994140625,1636.199951171875,1641.3399658203125,70,31,16,14,15,7,3,2,8.100147275405007,0.6657771918265366,0.6516150011758278,24,13,11,-3.35,202,191,265,658,-54.140430155595105
383,2022-06-10,1637.3599853515625,1640.8599853515625,1631.4300537109375,1632.6199951171875,36,18,6,5,20,8,3,3,2.3564064801178204,0.676621636270981,0.6512376007715168,10,3,7,-3.308333333333333,144,167,346,657,-55.236961483182675
384,2022-06-13,1611.8399658203125,1616.31005859375,1599.3399658203125,1600.06005859375,40,30,16,15,77,50,21,17,-5.44918998527246,0.6807038434781882,0.651153931598437,-20,-5,-15,-3.5083333333333333,64,63,530,657,-57.935340626298036
385,2022-06-14,1597.1700439453125,1605.530029296875,1590.75,1603.030029296875,20,16,9,9,76,50,14,12,-8.24742268041237,0.6705589159419564,0.6508780321516052,-34,-5,-29,-3.841666666666667,227,201,227,655,-57.935340626298036
386,2022-06-15,1605.5400390625,1606.31005859375,1589.280029296875,1593.5400390625,23,16,10,9,72,48,19,15,-7.216494845360825,0.6651949312676267,0.6505811709634219,-32,-9,-23,-4.116666666666666,171,164,320,655,-58.88561969216779
387,2022-06-16,1604.72998046875,1607.18994140625,1560.93994140625,1561.0999755859375,19,10,5,5,195,99,46,36,-25.920471281296024,0.6520141033809165,0.6500855728730702,-89,-41,-48,-4.583333333333333,50,86,517,653,-61.20247447655848
388,2022-06-17,1553.0699462890625,1567.8199462890625,1544.260009765625,1559.3900146484375,3,3,2,2,269,155,82,65,-39.175257731958766,0.6378275954444086,0.6493882552059991,-152,-80,-72,-5.175,254,163,237,654,-60.880514018450086
389,2022-06-20,1554.8399658203125,1563.969970703125,1549.97998046875,1559.2099609375,13,9,5,4,85,54,35,26,-10.603829160530191,0.62800616687298,0.6486066121421026,-45,-30,-15,-5.358333333333333,247,150,253,650,-61.07985066670562
390,2022-06-21,1568.6300048828125,1576.050048828125,1563.1400146484375,1574.52001953125,7,5,3,2,17,11,8,8,-1.4727540500736378,0.615884954751768,0.647558846312083,-6,-5,-1,-5.291666666666667,356,157,138,651,-59.90522441319217
391,2022-06-22,1571.3499755859375,1572.6600341796875,1551.4200439453125,1560.02001953125,8,5,4,3,77,48,26,15,-10.1620029455081,0.6047738436406569,0.6463083514372294,-43,-22,-21,-5.45,89,128,436,653,-61.54532272750755
392,2022-06-23,1564.2099609375,1565.530029296875,1555.52001953125,1557.6099853515625,11,6,5,5,86,60,33,27,-11.045655375552283,0.592931738377499,0.6448604881413231,-54,-28,-26,-5.683333333333334,183,182,291,656,-62.31354400710493
393,2022-06-24,1567.1400146484375,1570.6199951171875,1559.739990234375,1568.760009765625,8,4,2,1,58,33,17,12,-7.363770250368188,0.5827813624376492,0.6433228169924512,-29,-15,-14,-5.8,299,183,175,657,-61.49262193803975
394,2022-06-27,1577.8900146484375,1584.050048828125,1575.2900390625,1580.199951171875,12,6,3,3,18,12,8,7,-0.8836524300441826,0.5734379280942149,0.6416448540366205,-6,-5,-1,-5.708333333333333,343,168,144,655,-60.40748840114237
395,2022-06-28,1580.6800537109375,1596.27001953125,1576.75,1594.469970703125,10,5,4,4,10,8,4,3,0.0,0.5688082984645854,0.6398847923153579,-3,0,-3,-5.666666666666667,325,186,141,652,-59.41554222354435
396,2022-06-29,1588.030029296875,1590.050048828125,1582.52001953125,1586.1800537109375,12,6,3,3,24,14,8,6,-1.7673048600883652,0.560533240189527,0.6379583229276876,-8,-5,-3,-5.616666666666666,142,165,342,649,-60.51318482344125
397,2022-06-30,1587.8199462890625,1591.22998046875,1564.8199462890625,1568.3299560546875,15,7,5,4,72,46,29,22,-8.394698085419735,0.5493478569453203,0.6358403799808968,-39,-24,-15,-5.766666666666667,117,136,401,654,-61.952973940197566
398,2022-07-01,1571.18994140625,1575.77001953125,1563.3900146484375,1572.6700439453125,10,5,4,2,70,48,29,22,-8.836524300441827,0.5377316953291587,0.6335629995217271,-43,-25,-18,-5.958333333333333,240,193,219,652,-61.623964179429876
399,2022-07-04,1575.030029296875,1577.0999755859375,1559.6400146484375,1560.27001953125,18,10,5,5,145,100,68,56,-18.7039764359352,0.5244288033961297,0.6310803651023568,-90,-63,-27,-6.333333333333333,75,135,437,647,-63.255455738060306
400,2022-07-05,1566.510009765625,1569.9599609375,1539.3199462890625,1541.300048828125,16,6,5,4,292,206,144,115,-40.6480117820324,0.5107023732267465,0.6283825977198461,-200,-139,-61,-6.95,64,89,497,650,-65.44888025490859
401,2022-07-06,1539.6500244140625,1546.8399658203125,1530.4300537109375,1541.7900390625,6,2,1,1,273,193,148,120,-39.32253313696613,0.4991475633833461,0.6255317238574892,-191,-147,-44,-7.358333333333333,202,171,282,655,-66.13087459437907
402,2022-07-07,1545.3299560546875,1563.6500244140625,1542.75,1562.3699951171875,12,6,2,1,28,15,10,7,-2.3564064801178204,0.48883010306588576,0.6224912556388712,-9,-8,-1,-7.433333333333334,450,120,82,652,-64.38693585862899
403,2022-07-08,1568.5999755859375,1569.47998046875,1554.260009765625,1557.8699951171875,11,4,1,1,30,16,14,12,-2.7982326951399115,0.4795245475103302,0.6193571264515921,-12,-13,1,-7.508333333333334,143,149,359,651,-65.58693585862899
404,2022-07-11,1556.010009765625,1560.010009765625,1548.8699951171875,1557.4000244140625,15,6,0,0,42,25,14,10,-3.976435935198822,0.46891848690426957,0.616107557148873,-19,-14,-5,-7.675,225,205,216,646,-65.3779159543415
405,2022-07-12,1553.8299560546875,1556.9000244140625,1542.949951171875,1546.800048828125,10,7,2,2,47,31,24,22,-5.44918998527246,0.4571053000910828,0.612678537666704,-24,-22,-2,-7.791666666666667,161,202,284,647,-66.1563190183445
406,2022-07-14,1543.4000244140625,1550.3299560546875,1532.0799560546875,1536.8199462890625,10,7,3,3,83,68,50,42,-10.751104565537556,0.4453035982782822,0.60910950207589,-61,-47,-14,-8.1,119,156,374,649,-67.43076157164224
407,2022-07-15,1538.760009765625,1539.9599609375,1517.510009765625,1533.3699951171875,10,4,2,2,172,131,99,85,-23.85861561119293,0.43452252017047144,0.605445204507898,-127,-97,-30,-8.483333333333333,159,135,354,648,-68.6281852766906
408,2022-07-18,1539.1300048828125,1546.2900390625,1535.81005859375,1544.81005859375,14,7,3,1,33,24,16,14,-2.7982326951399115,0.4284239403876811,0.6018022798165419,-17,-13,-4,-8.566666666666666,358,167,127,652,-67.45558133673474
409,2022-07-19,1540.4200439453125,1541.550048828125,1520.77001953125,1533.4300537109375,9,3,1,0,74,45,34,26,-9.572901325478645,0.4122334641972049,0.5978561805220112,-42,-33,-9,-8.633333333333333,143,156,352,651,-68.6093621612776
410,2022-07-20,1542.5899658203125,1545.25,1535.52001953125,1539.3199462890625,11,4,2,2,18,12,9,7,-1.0309278350515463,0.4003514865257536,0.5936097090850032,-8,-7,-1,-8.508333333333333,276,203,169,648,-67.88513167039672
411,2022-07-21,1538.4000244140625,1547.8299560546875,1535.510009765625,1546.31005859375,19,8,3,2,30,25,17,16,-1.6200294550810015,0.38814560417281235,0.5890813749028971,-17,-14,-3,-8.5,310,198,142,650,-66.96631661526993
412,2022-07-22,1551.199951171875,1556.260009765625,1541.969970703125,1552.72998046875,21,7,4,4,12,8,6,4,1.3254786450662739,0.3798122708394791,0.5842752629430134,-1,-2,1,-8.308333333333334,266,192,194,652,-66.3555326969988
413,2022-07-25,1553.699951171875,1563.27001953125,1548.0999755859375,1560.31005859375,36,6,3,3,13,5,3,2,3.3873343151693667,0.3760243920516003,0.5793120241593359,1,0,1,-8.125,350,164,138,652,-65.22202112456185
414,2022-07-26,1563.1600341796875,1563.8399658203125,1551.9599609375,1553.1800537109375,21,4,2,2,18,11,8,7,0.4418262150220913,0.367691058718267,0.5740604970873703,-7,-6,-1,-7.833333333333333,143,186,320,649,-66.19491580754203
415,2022-07-27,1557.1099853515625,1576.780029296875,1555.6400146484375,1576.4100341796875,29,3,1,1,10,5,4,3,2.7982326951399115,0.36685772538493366,0.5688460070524417,-2,-3,1,-7.808333333333334,311,203,136,650,-65.26871759049834
416,2022-08-01,1584.9300537109375,1596.6600341796875,1581.22998046875,1593.239990234375,76,10,7,6,11,8,5,5,9.572901325478645,0.3682466142738225,0.5635591790545502,2,2,0,-7.366666666666666,397,135,119,651,-63.83899116664697
417,2022-08-02,1588.760009765625,1598.5400390625,1585.7099609375,1589.1600341796875,48,8,5,5,12,4,2,2,5.3019145802650955,0.3690402650674733,0.5582392822735898,4,3,1,-7.375,163,189,299,651,-64.68503458969582
418,2022-08-03,1590.52001953125,1597.739990234375,1586.489990234375,1594.72998046875,45,10,5,5,9,4,4,4,5.3019145802650955,0.37309119099339927,0.5531021155711928,6,1,5,-7.341666666666667,239,215,196,650,-64.23885741180112
419,2022-08-04,1599.9599609375,1604.8499755859375,1592.280029296875,1598.75,83,15,6,4,7,1,1,1,11.192930780559646,0.3839046830568913,0.5482609144772617,14,5,9,-7.308333333333334,280,190,183,653,-63.52621907214954
420,2022-08-05,1602.0400390625,1603.8599853515625,1595.8900146484375,1601.0899658203125,78,8,1,0,5,1,0,0,10.751104565537556,0.40057134972355796,0.5439247638883808,7,1,6,-7.35,245,188,216,649,-63.13450597122087
421,2022-08-08,1602.81005859375,1608.8800048828125,1589.6199951171875,1608.8699951171875,74,9,0,0,13,8,3,3,8.98379970544919,0.3999134549867158,0.5398259427341979,1,-3,4,-7.441666666666666,265,191,197,653,-62.539386935508965
422,2022-08-09,1608.9599609375,1620.97998046875,1606.47998046875,1618.800048828125,106,17,5,5,7,2,1,1,14.580265095729013,0.41259461440700573,0.53616525899279,15,4,11,-7.425,293,204,155,652,-61.71891711174497
423,2022-08-10,1616.4000244140625,1618.0699462890625,1606.0899658203125,1617.2099609375,61,14,5,4,17,10,6,6,6.480117820324006,0.4151703719827633,0.5327419489887558,4,-1,5,-7.475,162,156,335,653,-62.76863651616954
424,2022-08-11,1624.75,1626.280029296875,1612.6099853515625,1622.260009765625,83,22,8,8,27,16,5,5,8.24742268041237,0.42484538689033635,0.5297016807921822,6,3,3,-7.508333333333334,256,184,210,650,-62.26998969862365
425,2022-08-15,1621.199951171875,1630.1199951171875,1617.0,1625.25,101,26,12,12,30,14,5,4,10.456553755522828,0.43530800943935594,0.5270755261576999,12,7,5,-7.508333333333334,296,175,189,660,-61.49027529869599
426,2022-08-16,1629.43994140625,1632.8599853515625,1624.9200439453125,1629.949951171875,98,30,13,11,16,13,4,4,12.076583210603829,0.44249755192301604,0.5246849379720194,17,9,8,-7.458333333333333,214,174,272,660,-62.06597363239913
427,2022-08-17,1633.6500244140625,1642.1700439453125,1632.260009765625,1639.719970703125,90,22,7,5,10,7,3,2,11.782032400589102,0.44518985961532376,0.5223748341168233,15,4,11,-7.3,334,176,144,654,-61.02990108296853
428,2022-08-18,1638.739990234375,1641.31005859375,1630.989990234375,1636.0699462890625,69,20,7,6,11,7,4,4,8.541973490427099,0.447462586888051,0.5200852479383948,13,3,10,-7.0,237,193,225,655,-60.78119308128163
429,2022-08-19,1635.3499755859375,1638.75,1623.68994140625,1625.9200439453125,56,14,5,5,21,10,2,2,5.154639175257732,0.4468673487928129,0.5177236066221218,4,3,1,-6.958333333333333,157,176,319,652,-61.73788228749655
430,2022-08-22,1623.719970703125,1628.510009765625,1612.4100341796875,1615.8199462890625,37,13,5,5,32,9,4,4,0.7363770250368189,0.44338151001285653,0.5153113570996033,4,1,3,-7.008333333333334,153,205,295,653,-62.568135494867356
431,2022-08-23,1613.199951171875,1635.780029296875,1609.81005859375,1633.5699462890625,56,21,11,9,38,13,9,9,2.6509572901325478,0.4407834707971702,0.5128581411905301,8,2,6,-7.016666666666667,309,193,153,655,-61.67140604216704
432,2022-08-24,1632.969970703125,1638.75,1624.5999755859375,1631.550048828125,66,20,13,12,22,8,4,4,6.480117820324006,0.4381439534517705,0.5102897082544752,12,9,3,-7.025,199,185,275,659,-62.31062599690691
433,2022-08-25,1638.510009765625,1646.550048828125,1636.9100341796875,1643.52001953125,78,32,14,14,10,6,3,2,10.014727540500736,0.43648482826323354,0.507544050582372,26,11,15,-6.733333333333333,339,189,130,658,-61.26181714873675
434,2022-08-26,1646.1800537109375,1650.7099609375,1639.0400390625,1644.780029296875,61,24,10,10,23,10,6,5,5.596465390279823,0.43174997977838514,0.5046752868496628,14,4,10,-6.708333333333333,194,191,272,657,-61.89919458793585
435,2022-08-29,1622.4300537109375,1634.6300048828125,1619.5799560546875,1626.52001953125,29,15,10,9,54,21,8,8,-3.681885125184094,0.4243425723709777,0.5014622686060324,-6,2,-8,-6.391666666666667,126,161,372,659,-63.13147642198135
436,2022-08-30,1631.1700439453125,1641.510009765625,1627.7099609375,1639.449951171875,60,28,18,17,17,6,3,3,6.332842415316642,0.4219616199900253,0.49807067893383056,22,15,7,-6.366666666666666,323,179,154,656,-62.162513631731436
437,2022-08-31,1632.9200439453125,1644.0899658203125,1630.010009765625,1638.9300537109375,56,32,14,13,26,9,5,5,4.418262150220913,0.4196589884110779,0.494582841698276,23,9,14,-6.2,197,172,284,653,-62.87166112937238
438,2022-09-01,1636.52001953125,1640.6500244140625,1617.75,1621.949951171875,38,20,10,9,59,17,9,9,-3.0927835051546393,0.4143283541330752,0.49095960988653725,3,1,2,-6.208333333333333,114,152,388,654,-64.20988744550975
439,2022-09-02,1622.8599853515625,1626.47998046875,1611.18994140625,1622.1500244140625,36,17,7,7,54,12,5,5,-2.6509572901325478,0.41016168746640863,0.48717434103776147,5,2,3,-6.225,242,217,194,653,-63.74065031330628
440,2022-09-05,1622.3800048828125,1622.719970703125,1611.8599853515625,1622.0,37,19,6,5,47,16,8,7,-1.4727540500736378,0.4042093065140276,0.48321711451702815,3,-2,5,-6.275,214,181,260,655,-64.24339005984245
441,2022-09-06,1626.6199951171875,1636.699951171875,1624.9200439453125,1633.8699951171875,49,24,10,8,22,9,7,7,3.976435935198822,0.39873545030487734,0.47899339250921097,15,3,12,-6.158333333333333,328,163,164,655,-63.243390059842454
442,2022-09-07,1631.489990234375,1641.25,1628.800048828125,1639.9200439453125,53,29,8,7,18,7,6,6,5.154639175257732,0.39422417210938854,0.4744675088472585,22,2,20,-5.3,225,180,248,653,-63.599861409609055
443,2022-09-08,1645.75,1649.1700439453125,1636.3299560546875,1640.0,55,28,10,8,22,5,4,4,4.860088365243004,0.3950178229030394,0.46977411195779284,23,6,17,-3.8666666666666667,217,197,241,655,-63.94801672152045
444,2022-09-09,1646.6400146484375,1658.9599609375,1641.8199462890625,1654.6199951171875,41,27,11,7,17,6,5,5,3.5346097201767304,0.3992689490291655,0.4650835303836425,21,6,15,-3.7083333333333335,266,205,184,655,-63.317098143233856
445,2022-09-12,1661.3900146484375,1672.6400146484375,1660.8299560546875,1665.739990234375,71,43,18,16,6,0,0,0,9.572901325478645,0.40941387656539735,0.4607311130606998,43,18,25,-3.533333333333333,320,183,149,652,-62.35307126285813
446,2022-09-13,1669.5799560546875,1671.18994140625,1660.81005859375,1661.0899658203125,59,40,11,9,10,2,2,2,7.216494845360825,0.41776931423117986,0.456607352776759,38,9,29,-3.341666666666667,212,211,231,654,-62.65244167139817
447,2022-09-14,1643.3900146484375,1660.4200439453125,1642.530029296875,1656.5799560546875,46,27,9,8,19,5,1,1,3.976435935198822,0.4311353273030753,0.4529260398421283,22,8,14,-3.283333333333333,202,216,234,652,-63.03645395998803
448,2022-09-15,1660.1400146484375,1661.0400390625,1642.0699462890625,1642.3299560546875,58,34,14,13,18,7,3,3,5.891016200294551,0.44446399210232834,0.44970331311976036,27,11,16,-3.1666666666666665,127,171,355,653,-64.18779291761469
449,2022-09-16,1639.1500244140625,1642.72998046875,1629.31005859375,1630.4000244140625,42,22,6,6,45,10,5,5,-0.4418262150220913,0.4514715678599041,0.4467610698028757,12,1,11,-3.1,135,153,363,651,-65.40455891012084
450,2022-09-19,1632.6099853515625,1638.6800537109375,1628.9599609375,1631.5699462890625,43,23,6,5,72,23,9,8,-4.270986745213549,0.45359277998111625,0.4440562002233649,0,-3,3,-3.15,164,181,305,650,-66.28474370590254
451,2022-09-20,1640.6199951171875,1645.1500244140625,1636.199951171875,1638.5899658203125,34,24,8,7,32,9,4,4,0.29455081001472755,0.46248166887000514,0.44168466397718736,15,4,11,-3.091666666666667,299,183,168,650,-65.44096854524709
452,2022-09-21,1640.5,1642.8199462890625,1633.4100341796875,1633.449951171875,28,16,4,4,45,16,10,10,-2.503681885125184,0.4650505911757695,0.4395533115238252,0,-6,6,-3.091666666666667,161,178,312,651,-66.35943216401182
453,2022-09-22,1631.010009765625,1649.2900390625,1627.3399658203125,1645.2900390625,24,15,4,3,54,13,7,7,-4.418262150220913,0.46935681127146334,0.4376629023377221,2,-3,5,-3.1083333333333334,349,182,119,650,-65.23834759936342
454,2022-09-23,1646.02001953125,1647.3399658203125,1631.5,1631.7099609375,37,27,11,9,46,12,5,5,-1.3254786450662739,0.4762696900593421,0.43604343170380755,15,6,9,-3.1333333333333333,129,163,360,652,-66.42516543937336
455,2022-09-26,1626.6099853515625,1627.949951171875,1615.3199462890625,1621.25,25,14,5,3,126,36,19,17,-14.874815905743741,0.47140857894823096,0.4344201030452016,-22,-14,-8,-3.3,111,147,392,650,-67.8030800407361
456,2022-09-27,1622.739990234375,1627.300048828125,1610.3199462890625,1610.5799560546875,27,14,2,2,160,55,32,30,-19.587628865979383,0.4678435165596391,0.43287527431803685,-41,-30,-11,-3.433333333333333,92,128,431,651,-69.42416207960527
457,2022-09-28,1600.93994140625,1606.22998046875,1595.760009765625,1599.22998046875,11,8,2,1,238,89,51,48,-33.43151693667158,0.46602146698509234,0.4314865011520331,-81,-49,-32,-3.75,158,141,352,651,-70.59300645893838
458,2022-09-29,1607.8399658203125,1617.22998046875,1589.7900390625,1592.3699951171875,16,13,3,2,128,46,30,27,-16.49484536082474,0.46551641648004183,0.4302829131712144,-33,-27,-6,-3.8666666666666667,142,180,327,649,-71.60399579988803
459,2022-09-30,1589.97998046875,1597.43994140625,1584.219970703125,1589.510009765625,11,8,1,1,145,58,42,41,-19.734904270986746,0.46476246086785117,0.42928847412907645,-50,-41,-9,-4.05,256,193,202,651,-71.07640645630353
460,2022-10-03,1586.510009765625,1592.719970703125,1556.72998046875,1558.050048828125,10,7,3,3,223,85,58,57,-31.36966126656848,0.4650228488826676,0.4285271487233418,-78,-55,-23,-4.291666666666667,77,105,470,652,-73.00190565646211
461,2022-10-04,1576.9300537109375,1584.5699462890625,1567.47998046875,1578.0,11,6,4,4,66,40,28,27,-8.100147275405007,0.46699432539273467,0.4279912614234983,-34,-24,-10,-4.4,378,144,132,654,-71.6993882000962
462,2022-10-05,1586.5799560546875,1590.3399658203125,1576.7099609375,1580.27001953125,13,10,6,5,52,26,11,11,-5.743740795287187,0.47009890055613346,0.42767907471500244,-16,-5,-11,-4.533333333333333,243,179,230,652,-71.43064627515291
463,2022-10-06,1586.3599853515625,1597.800048828125,1586.1600341796875,1589.1800537109375,13,10,5,4,32,16,10,9,-2.7982326951399115,0.4745433450005779,0.4275960546731732,-6,-5,-1,-4.583333333333333,314,183,150,647,-70.48655711208298
464,2022-10-07,1590.3599853515625,1592.1199951171875,1572.52001953125,1579.6600341796875,14,9,7,7,59,34,19,17,-6.62739322533137,0.47903052448775735,0.42776458863289796,-25,-12,-13,-4.641666666666667,161,184,302,647,-71.3595761050964
465,2022-10-10,1570.3800048828125,1573.4100341796875,1562.3499755859375,1570.5699462890625,5,5,4,4,126,75,56,51,-17.820324005891017,0.4788595843168172,0.42812716003666024,-70,-52,-18,-4.758333333333334,114,143,395,652,-72.75649732294974
466,2022-10-11,1567.3699951171875,1569.1300048828125,1559.219970703125,1562.6800537109375,9,5,1,1,120,75,54,48,-16.347569955817377,0.47821921839343234,0.428675753705246,-70,-53,-17,-4.875,137,159,351,647,-73.91300067357177
467,2022-10-12,1564.4200439453125,1567.030029296875,1557.739990234375,1560.780029296875,13,8,1,1,105,66,43,41,-13.549337260677467,0.47826797326891995,0.42940484459022016,-58,-42,-16,-4.9,232,179,235,646,-74.04210011844535
468,2022-10-17,1563.050048828125,1573.6700439453125,1553.800048828125,1571.4000244140625,14,10,2,2,105,69,48,44,-13.402061855670103,0.4763030609882181,0.43020282993356246,-59,-46,-13,-5.075,275,164,208,647,-73.40487126939611
469,2022-10-18,1577.75,1594.6800537109375,1576.6199951171875,1590.3599853515625,22,9,1,1,8,7,6,6,2.0618556701030926,0.4782078228929801,0.43130240257849206,2,-5,7,-5.0,418,140,96,654,-71.89368367572601
470,2022-10-19,1592.6199951171875,1596.030029296875,1583.81005859375,1588.719970703125,17,5,1,1,16,5,3,2,0.14727540500736377,0.4793441865293437,0.43261894757855196,0,-2,2,-5.033333333333333,194,191,265,650,-72.50178865569795
471,2022-10-20,1585.1199951171875,1595.5699462890625,1579.780029296875,1592.72998046875,22,10,5,5,23,15,8,8,-0.14727540500736377,0.4832544429396001,0.4342040948913317,-5,-3,-2,-5.15,289,186,174,649,-71.71758634632104
472,2022-10-21,1592.719970703125,1597.9300537109375,1588.010009765625,1591.3199462890625,14,9,3,3,17,13,8,7,-0.4418262150220913,0.481133230818388,0.4358927775576468,-4,-5,1,-5.166666666666667,173,193,288,654,-72.4875106966014
473,2022-10-25,1598.2900390625,1602.8800048828125,1593.6800537109375,1600.6600341796875,31,19,9,8,29,22,13,13,0.29455081001472755,0.47961807930323647,0.4376193390118408,-3,-4,1,-5.158333333333333,198,170,284,652,-73.196682027528
474,2022-10-26,1602.6199951171875,1604.989990234375,1593.7900390625,1596.4599609375,42,17,5,5,18,12,7,6,3.5346097201767304,0.4832291904143476,0.4395449745401088,5,-2,7,-5.166666666666667,259,205,184,648,-72.59329353749615
475,2022-10-27,1600.4000244140625,1605.760009765625,1592.489990234375,1602.3299560546875,47,20,4,4,23,15,8,6,3.5346097201767304,0.4854514126365698,0.44152153599430277,5,-4,9,-4.9,301,191,158,650,-71.73028040511248
476,2022-10-28,1603.43994140625,1607.75,1598.1800537109375,1606.0699462890625,30,14,9,8,15,9,6,6,2.2091310751104567,0.4857291904143476,0.4434795789299782,5,3,2,-4.908333333333333,162,185,307,654,-72.61321295773081
477,2022-10-31,1614.6600341796875,1619.0799560546875,1605.760009765625,1608.760009765625,52,21,9,8,26,15,6,6,3.829160530191458,0.4838244285095857,0.44539264832068004,6,3,3,-4.95,254,178,219,651,-72.17102439358992
478,2022-11-01,1614.22998046875,1628.2900390625,1613.9599609375,1625.72998046875,57,14,8,7,10,5,4,4,6.9219440353460975,0.4856762803614375,0.44726906647681397,9,4,5,-4.75,374,161,119,654,-70.91640330574145
479,2022-11-02,1627.9200439453125,1630.56005859375,1622.300048828125,1625.02001953125,57,16,5,4,15,9,3,2,6.185567010309279,0.4818072327423899,0.448900775638239,7,2,5,-4.516666666666667,177,187,286,650,-71.67784091582028
480,2022-11-03,1621.8699951171875,1628.780029296875,1619.989990234375,1625.6199951171875,45,12,4,2,29,13,5,4,2.3564064801178204,0.4725479734831307,0.45010038603423186,-1,-1,0,-4.025,250,195,209,654,-71.2204748988608
481,2022-11-04,1628.1300048828125,1635.9300537109375,1626.18994140625,1626.3199462890625,58,14,3,3,11,4,2,2,6.9219440353460975,0.48254797348313067,0.4514776280091722,10,1,9,-3.3,302,207,142,651,-70.34341687955377
482,2022-11-07,1632.18994140625,1634.6500244140625,1621.0999755859375,1623.5699462890625,60,13,2,1,17,11,3,3,6.332842415316642,0.4753257512609084,0.4525231469567372,2,-1,3,-2.816666666666667,205,181,267,653,-70.92707717515331
483,2022-11-08,1628.18994140625,1635.8699951171875,1627.9300537109375,1632.6099853515625,66,20,3,3,14,9,2,2,7.658321060382916,0.47774999368515086,0.453566140651777,11,1,10,-2.625,242,195,216,653,-70.56286149561097
484,2022-11-09,1633.5799560546875,1635.3699951171875,1619.68994140625,1622.449951171875,43,16,6,5,40,21,8,7,0.4418262150220913,0.47463644057159776,0.45439599154646465,-5,-2,-3,-2.0166666666666666,117,175,362,654,-71.74271125492164
485,2022-11-10,1614.010009765625,1623.969970703125,1611.1700439453125,1619.22998046875,40,13,4,4,55,34,19,16,-2.2091310751104567,0.46577028541388255,0.4549036961460401,-21,-15,-6,-1.6416666666666666,178,181,290,649,-72.52717579547438
486,2022-11-11,1635.3599853515625,1640.030029296875,1629.5699462890625,1637.2900390625,64,19,6,6,66,43,26,22,-0.29455081001472755,0.45615018737466684,0.4551312400702343,-24,-20,-4,-1.5916666666666666,296,180,176,652,-71.71293785395214
487,2022-11-14,1630.4599609375,1633.760009765625,1618.280029296875,1623.3800048828125,38,11,3,3,111,74,39,35,-10.751104565537556,0.4456739968984763,0.4551393090249534,-63,-36,-27,-1.825,118,144,390,652,-73.08255899462043
488,2022-11-15,1625.5799560546875,1632.4200439453125,1623.3299560546875,1629.3800048828125,40,12,2,2,79,51,24,20,-5.743740795287187,0.436349987574467,0.4549540990363937,-39,-22,-17,-1.9416666666666667,275,180,197,652,-72.4260993793208
489,2022-11-16,1628.739990234375,1629.06005859375,1616.8199462890625,1619.97998046875,35,17,6,6,50,32,18,16,-2.2091310751104567,0.42861189233637176,0.4546498414287864,-15,-12,-3,-1.9583333333333333,173,161,321,655,-73.3819132978811
490,2022-11-17,1617.6500244140625,1619.050048828125,1611.280029296875,1614.949951171875,33,20,7,7,51,31,14,13,-2.6509572901325478,0.42490818863266805,0.45434195273911654,-11,-7,-4,-2.058333333333333,205,181,272,658,-73.98865201275915
491,2022-11-18,1615.5799560546875,1622.030029296875,1610.75,1617.3800048828125,23,12,3,3,76,50,25,23,-7.80559646539028,0.41752723625171567,0.45395434883002567,-38,-22,-16,-2.2666666666666666,165,187,302,654,-74.8423049892404
492,2022-11-21,1613.4300537109375,1623.300048828125,1611.449951171875,1618.8599853515625,28,15,7,5,75,49,27,23,-6.9219440353460975,0.40821351076151957,0.4534555081185215,-34,-20,-14,-2.425,233,194,228,655,-74.68217683543531
493,2022-11-22,1620.3399658203125,1629.219970703125,1612.25,1615.3299560546875,23,11,6,5,80,58,35,33,-8.394698085419735,0.3969270449556851,0.45279621173006235,-47,-29,-18,-2.625,154,173,330,657,-75.6879075413768
494,2022-11-23,1619.8699951171875,1626.219970703125,1617.56005859375,1624.4000244140625,24,12,5,4,60,42,27,25,-5.3019145802650955,0.3891145449556851,0.452085621149684,-30,-22,-8,-2.7416666666666667,251,196,208,655,-75.22070939104321
495,2022-11-24,1628.7900390625,1630.0799560546875,1621.5699462890625,1624.9599609375,33,12,5,4,66,46,27,26,-4.860088365243004,0.3824594523630925,0.45138756914955264,-34,-22,-12,-2.925,205,190,256,651,-75.7374450166839
496,2022-11-25,1622.3900146484375,1622.8900146484375,1615.949951171875,1620.8399658203125,25,11,6,5,46,23,15,15,-3.0927835051546393,0.372935642839283,0.4505704695303736,-12,-9,-3,-3.0416666666666665,241,209,197,647,-75.27970730846684
497,2022-11-28,1616.4300537109375,1620.780029296875,1612.56005859375,1616.9100341796875,31,14,3,3,42,28,18,18,-1.6200294550810015,0.3630358934658494,0.44962675128128643,-14,-15,1,-3.158333333333333,202,182,263,647,-75.85705757765646
498,2022-11-29,1619.22998046875,1625.6700439453125,1613.8699951171875,1624.3900146484375,24,10,5,4,18,13,8,7,0.8836524300441826,0.36067422005154437,0.4487325157132609,-3,-3,0,-3.225,269,200,179,648,-75.18790797253826
499,2022-11-30,1626.1400146484375,1636.0799560546875,1622.239990234375,1635.3599853515625,40,19,10,9,12,6,5,5,4.123711340206185,0.36206310894043325,0.44793087273782795,13,5,8,-3.2083333333333335,271,197,187,655,-74.53656902525933
500,2022-12-01,1642.1600341796875,1651.760009765625,1639.02001953125,1648.43994140625,52,24,10,10,16,13,7,7,5.3019145802650955,0.3647241733662036,0.44727278718536423,11,3,8,-3.216666666666667,287,186,180,653,-73.78013494791419
501,2022-12-02,1649.7900390625,1651.18994140625,1639.1300048828125,1641.6300048828125,41,23,13,11,20,9,5,5,3.0927835051546393,0.36695728883461315,0.44674315116085983,14,8,6,-3.25,180,201,275,656,-74.46591700491406
502,2022-12-06,1639.25,1640.8699951171875,1628.6600341796875,1632.969970703125,39,15,10,6,35,16,6,5,0.5891016200294551,0.3678501459774703,0.4463035840586612,-1,4,-5,-3.3833333333333333,153,169,333,655,-75.49490851576911
503,2022-12-07,1632.199951171875,1636.1500244140625,1621.010009765625,1622.280029296875,33,17,9,7,43,27,13,12,-1.4727540500736378,0.3627635658908902,0.44576601310845876,-10,-4,-6,-3.4916666666666667,163,205,285,653,-76.26447528331352
504,2022-12-08,1624.2900390625,1625.9000244140625,1615.06005859375,1620.489990234375,31,11,6,5,43,24,11,11,-1.7673048600883652,0.35718758549873336,0.44506465704961823,-13,-5,-8,-3.433333333333333,246,216,193,655,-75.77026922169912
505,2022-12-09,1621.969970703125,1629.9300537109375,1618.1300048828125,1623.1300048828125,25,9,4,4,19,9,5,5,0.8836524300441826,0.34792832623947406,0.44403989787751946,0,-1,1,-3.183333333333333,223,208,227,658,-75.90861211447233
506,2022-12-13,1629.8299560546875,1633.0699462890625,1621.4100341796875,1625.9100341796875,35,17,5,5,35,20,12,12,0.0,0.3387277229212237,0.44272253802235356,-3,-7,4,-2.9583333333333335,197,187,271,655,-76.53600116544199
507,2022-12-14,1630.489990234375,1638.8800048828125,1628.1700439453125,1633.3599853515625,49,23,7,7,36,24,16,16,1.914580265095729,0.3288001866893397,0.44101695234545796,-1,-9,8,-2.4916666666666667,273,220,157,650,-75.81151039405283
508,2022-12-15,1632.6400146484375,1634.02001953125,1616.989990234375,1620.280029296875,23,11,2,2,63,43,23,23,-5.891016200294551,0.31640802982659455,0.4388826863075291,-32,-21,-11,-1.9833333333333334,97,174,377,648,-77.07642145812018
509,2022-12-16,1615.550048828125,1620.43994140625,1612.02001953125,1619.010009765625,26,9,4,4,66,44,25,25,-5.891016200294551,0.3096159713103981,0.4365184263650373,-35,-21,-14,-1.975,219,201,230,650,-77.30977836404875
510,2022-12-19,1619.030029296875,1624.3399658203125,1613.93994140625,1618.199951171875,37,25,9,9,64,42,29,29,-3.976435935198822,0.3068966730647841,0.434073491249765,-17,-20,3,-1.9416666666666667,205,202,245,652,-77.75367512566723
511,2022-12-20,1619.719970703125,1621.5400390625,1597.030029296875,1604.43994140625,31,13,5,5,123,83,53,53,-13.549337260677467,0.29722234356286836,0.43131916916131274,-70,-48,-22,-1.95,102,141,411,654,-79.2288213347015
512,2022-12-21,1611.260009765625,1612.6099853515625,1605.2900390625,1609.93994140625,18,7,2,2,69,41,25,25,-7.511045655375552,0.29369500670219817,0.42846324275341996,-34,-23,-11,-1.825,226,193,229,648,-79.35317533554495
513,2022-12-22,1614.530029296875,1618.8599853515625,1611.81005859375,1616.6700439453125,19,8,2,1,43,22,16,15,-3.5346097201767304,0.28948625249344395,0.42546540010711964,-14,-14,0,-1.7083333333333333,274,206,168,648,-78.63757957347953
514,2022-12-23,1611.9200439453125,1619.3199462890625,1609.8199462890625,1617.550048828125,27,13,3,2,40,22,15,15,-1.914580265095729,0.2808056969378884,0.42220766688842865,-9,-12,3,-1.675,209,224,216,649,-78.81396299421716
515,2022-12-26,1620.68994140625,1629.260009765625,1619.68994140625,1626.800048828125,42,21,6,6,20,12,10,10,3.240058910162003,0.2835834747156662,0.4190772484845527,9,-4,13,-1.5416666666666667,306,195,150,651,-77.9218204230174
516,2022-12-27,1632.06005859375,1645.760009765625,1631.1400146484375,1643.1600341796875,77,39,8,7,11,5,3,3,9.720176730486008,0.2947242946800156,0.41619192811989225,34,5,29,-1.275,401,152,100,653,-76.51920848044814
517,2022-12-28,1644.0,1649.4200439453125,1641.5400390625,1647.280029296875,77,39,8,6,1,1,0,0,11.192930780559646,0.31076203052907214,0.41360427084562523,38,8,30,-0.9,280,184,185,649,-75.80260990836366
518,2022-12-29,1644.72998046875,1662.0699462890625,1642.47998046875,1661.199951171875,78,40,10,8,8,5,3,3,10.309278350515465,0.3220673918344335,0.4112134537681984,35,7,28,-0.5166666666666667,295,207,148,650,-74.96193710088696
519,2022-12-30,1662.6500244140625,1678.1700439453125,1661.47998046875,1668.6600341796875,92,47,12,9,2,2,1,1,13.25478645066274,0.33706441031982404,0.4090851529257314,45,11,34,-0.008333333333333333,252,196,210,658,-74.50020344438882
520,2023-01-03,1675.699951171875,1683.3800048828125,1673.2900390625,1678.969970703125,71,40,13,11,14,4,2,2,8.394698085419735,0.350689182633121,0.4071795918215722,36,11,25,0.7083333333333334,238,161,259,658,-74.86024459430037
521,2023-01-04,1680.0699462890625,1685.1099853515625,1668.0699462890625,1673.25,64,39,16,14,25,7,3,2,5.743740795287187,0.3626409370190859,0.4054403686820114,32,13,19,1.2333333333333334,174,176,302,652,-75.71063499982475
522,2023-01-05,1674.81005859375,1676.8199462890625,1659.9000244140625,1663.8599853515625,73,50,14,12,34,15,9,8,5.743740795287187,0.36690351161414125,0.4037204455329782,35,5,30,1.4916666666666667,210,181,261,652,-76.2399928940889
523,2023-01-06,1667.1400146484375,1677.7900390625,1665.489990234375,1673.8599853515625,80,43,18,13,24,16,9,8,8.24742268041237,0.3724590671696968,0.4020190409024635,27,9,18,1.6333333333333333,314,205,138,657,-75.31567209910546
524,2023-01-09,1685.300048828125,1693.4200439453125,1684.9000244140625,1691.1199951171875,102,61,18,13,21,13,7,6,11.929307805596466,0.37997188768251733,0.4003680636223762,48,11,37,1.9833333333333334,351,170,139,660,-74.2022242638337
525,2023-01-10,1694.1700439453125,1695.530029296875,1684.9000244140625,1691.4100341796875,97,35,11,9,10,5,2,2,12.812960235640649,0.3929633406739704,0.39893645956166207,30,9,21,2.175,294,176,188,658,-73.42835731370779
526,2023-01-11,1693.219970703125,1695.1300048828125,1681.8800048828125,1685.75,101,37,8,8,3,1,0,0,14.43298969072165,0.40932697703760673,0.397788255539065,36,8,28,2.525,236,186,234,656,-73.32493977570878
527,2023-01-12,1688.3399658203125,1690.3199462890625,1679.989990234375,1687.449951171875,87,38,11,8,8,3,0,0,11.634756995581737,0.4256148558254855,0.39691070358167446,35,11,24,2.975,277,194,184,655,-72.63434360070991
528,2023-01-13,1691.52001953125,1695.989990234375,1673.9200439453125,1681.72998046875,87,41,7,6,10,3,0,0,11.34020618556701,0.44161485582548554,0.39633256682896223,38,7,31,3.2666666666666666,196,192,262,650,-73.21912468104433
529,2023-01-16,1686.3499755859375,1691.3499755859375,1679.989990234375,1684.8599853515625,78,37,13,9,5,4,1,1,10.751104565537556,0.45471009392072353,0.3959409380127579,33,12,21,3.5166666666666666,260,198,194,652,-72.6432268676631
530,2023-01-17,1686.0899658203125,1688.56005859375,1679.199951171875,1681.0400390625,68,38,7,4,8,0,0,0,8.836524300441827,0.46721009392072355,0.39573870313594756,38,7,31,3.783333333333333,242,199,210,651,-72.2432268676631
531,2023-01-18,1682.0400390625,1689.4100341796875,1679.1500244140625,1685.43994140625,69,33,10,7,12,4,2,2,8.394698085419735,0.47468872639935605,0.39559594119361013,29,8,21,3.9833333333333334,253,174,229,656,-71.87289882775407
532,2023-01-19,1682.1300048828125,1690.68994140625,1681.719970703125,1688.47998046875,59,35,19,14,5,2,1,1,7.952871870397644,0.48597660518723484,0.3956766640997576,33,18,15,4.1,207,184,263,654,-72.42308307207837
533,2023-01-20,1687.4200439453125,1688.5899658203125,1672.489990234375,1677.25,67,38,16,14,12,5,3,2,8.100147275405007,0.49319351108835124,0.39590292129617616,33,13,20,4.258333333333334,182,177,296,655,-73.22336392165697
534,2023-01-23,1681.3299560546875,1689.52001953125,1677.52001953125,1684.0400390625,53,28,10,9,7,1,0,0,6.774668630338733,0.5029157333105735,0.3962310303444466,27,10,17,4.408333333333333,272,201,183,656,-72.55959132550228
535,2023-01-24,1689.9000244140625,1693.969970703125,1682.5799560546875,1682.93994140625,57,33,11,8,15,6,3,2,6.185567010309279,0.510455415850256,0.3966477637313414,27,8,19,4.558333333333334,210,190,255,655,-73.04497992677021
536,2023-01-25,1686.1300048828125,1687.510009765625,1678.7099609375,1682.1099853515625,62,41,11,10,25,6,1,1,5.44918998527246,0.5157331936280338,0.3971478304515695,35,10,25,4.766666666666667,177,193,287,657,-73.79798079614444
537,2023-01-26,1682.800048828125,1684.8399658203125,1667.4300537109375,1671.3399658203125,34,18,9,8,44,15,5,4,-1.4727540500736378,0.5164474793423195,0.39769154796544837,3,4,-1,4.75,136,182,339,657,-74.85120898485111
538,2023-01-27,1674.4100341796875,1683.77001953125,1670.9100341796875,1681.300048828125,40,22,10,8,15,5,3,3,3.681885125184094,0.5181568810517213,0.39823289131028644,17,7,10,4.791666666666667,344,188,122,654,-73.76741787278054
539,2023-01-30,1683.56005859375,1685.239990234375,1676.510009765625,1681.219970703125,44,24,10,7,11,7,3,3,4.860088365243004,0.5205607272055673,0.39887878288467277,17,7,10,4.8,235,200,220,655,-73.49423869042647
540,2023-01-31,1681.6600341796875,1683.9000244140625,1671.0,1671.4599609375,52,37,16,13,28,9,3,3,3.5346097201767304,0.5271884075174582,0.39978945678524486,28,13,15,4.875,221,188,252,661,-73.89923395462245
541,2023-02-01,1676.6700439453125,1687.97998046875,1675.72998046875,1685.75,65,47,13,9,13,6,5,4,7.658321060382916,0.5292254445544953,0.40056741463643425,41,8,33,5.116666666666666,327,172,156,655,-72.90503110491903
542,2023-02-02,1689.1600341796875,1692.93994140625,1681.739990234375,1682.5799560546875,58,38,12,8,9,1,0,0,7.216494845360825,0.5392254445544952,0.4016324095246607,37,12,25,5.233333333333333,229,179,246,654,-73.21234925349546
543,2023-02-03,1684.3299560546875,1690.4000244140625,1679.0,1688.3599853515625,66,35,11,7,10,3,1,1,8.24742268041237,0.544503222332273,0.40274496333544607,32,10,22,5.375,243,198,215,656,-72.83724457798749
544,2023-02-06,1686.010009765625,1687.780029296875,1680.219970703125,1682.1099853515625,64,44,14,11,21,8,1,1,6.332842415316642,0.5529159207449715,0.40404962133833566,36,13,23,5.541666666666667,227,188,242,657,-73.11896266289699
545,2023-02-07,1684.68994140625,1689.510009765625,1676.1400146484375,1680.489990234375,68,50,14,14,25,3,1,1,6.332842415316642,0.5655729255758893,0.4057129986743691,47,13,34,5.783333333333333,211,177,269,657,-73.68978899080173
546,2023-02-08,1683.530029296875,1684.75,1667.7900390625,1670.3399658203125,50,35,15,11,54,16,5,5,-0.5891016200294551,0.5749479255758894,0.40769296097772284,19,10,9,5.791666666666667,114,144,397,655,-75.0868301991886
547,2023-02-09,1670.0799560546875,1672.0899658203125,1656.739990234375,1669.1700439453125,24,18,6,5,85,25,9,7,-8.98379970544919,0.5804241160520797,0.40993879629694957,-7,-3,-4,5.666666666666667,238,189,228,655,-74.85741446531803
548,2023-02-10,1665.8499755859375,1668.969970703125,1660.0999755859375,1664.5699462890625,22,19,6,6,30,11,3,2,-1.1782032400589102,0.5902531758811397,0.4125038494353941,8,3,5,5.625,185,208,261,654,-75.46043715447355
549,2023-02-13,1661.3699951171875,1669.97998046875,1658.4300537109375,1664.8900146484375,31,23,9,7,52,13,7,7,-3.0927835051546393,0.595461509214473,0.4152846763833624,10,2,8,5.683333333333334,171,197,286,654,-76.22254481144078
550,2023-02-14,1667.969970703125,1669.7099609375,1648.739990234375,1652.760009765625,15,9,2,1,119,29,13,11,-15.316642120765833,0.5921281758811396,0.41807167617083696,-20,-11,-9,5.583333333333333,93,132,430,655,-77.81434711903623
551,2023-02-15,1651.18994140625,1657.530029296875,1642.969970703125,1647.3900146484375,8,6,1,1,201,53,24,22,-28.424153166421206,0.5910091282620921,0.4209630410376766,-47,-23,-24,5.333333333333333,95,134,424,653,-79.37544834478587
552,2023-02-16,1653.8499755859375,1660.5799560546875,1648.989990234375,1658.2900390625,16,12,2,0,100,33,16,16,-12.371134020618557,0.5894296075649241,0.4239833093177333,-21,-14,-7,5.25,328,178,145,651,-78.36433689261303
553,2023-02-17,1654.8699951171875,1657.02001953125,1643.8199462890625,1651.6700439453125,10,8,0,0,124,45,16,14,-16.78939617083947,0.5869905831746803,0.42715103495471657,-37,-16,-21,4.95,154,157,342,653,-79.4551500836414
554,2023-02-20,1654.9000244140625,1660.1800537109375,1650.3900146484375,1657.68994140625,19,13,6,4,42,15,7,5,-3.3873343151693667,0.5920787242003215,0.43053377127546055,-2,-1,-1,4.858333333333333,367,160,127,654,-78.23421469230668
555,2023-02-21,1659.699951171875,1669.510009765625,1652.25,1668.6300048828125,27,21,8,8,21,10,4,4,0.8836524300441826,0.6005856686447658,0.43416920821348837,11,4,7,4.983333333333333,317,181,155,653,-77.29075833925695
556,2023-02-22,1665.5999755859375,1667.989990234375,1656.5,1659.47998046875,28,21,9,7,31,10,4,4,-0.4418262150220913,0.6073622254213227,0.438076317923189,11,5,6,4.975,186,175,295,656,-78.07772605258336
557,2023-02-23,1657.780029296875,1658.9200439453125,1647.3699951171875,1652.469970703125,22,18,7,6,47,18,6,5,-3.681885125184094,0.6139556320147292,0.44225831356567036,0,1,-1,4.85,201,198,258,657,-78.61291962579217
558,2023-02-24,1653.1199951171875,1654.0899658203125,1631.5400390625,1634.02001953125,25,17,7,6,86,31,10,8,-8.98379970544919,0.6144081207025119,0.44648721190985324,-14,-3,-11,4.741666666666666,134,149,369,652,-79.86458518282674
559,2023-02-27,1633.1600341796875,1635.3499755859375,1624.6199951171875,1627.3499755859375,26,19,9,6,114,52,18,18,-12.960235640648012,0.6088525651469564,0.45060036951329524,-33,-9,-24,4.516666666666667,179,163,312,654,-80.76512702513952
560,2023-02-28,1633.81005859375,1637.4100341796875,1618.0899658203125,1622.3499755859375,24,15,10,6,116,50,22,21,-13.549337260677467,0.6042569769116624,0.4545925829057195,-35,-12,-23,4.283333333333333,192,157,308,657,-81.62196844290006
561,2023-03-01,1627.1800537109375,1628.9200439453125,1619.719970703125,1619.97998046875,20,13,7,7,121,83,35,32,-14.874815905743741,0.5949977176524031,0.45839325671934933,-70,-28,-42,3.8333333333333335,174,142,341,657,-82.70263128015883
562,2023-03-02,1618.969970703125,1626.550048828125,1608.6700439453125,1612.6400146484375,11,10,3,3,161,91,42,40,-22.091310751104565,0.5856921620968476,0.46202395698800564,-81,-39,-42,3.316666666666667,152,113,390,655,-84.14752549713307
563,2023-03-03,1614.31005859375,1615.3900146484375,1604.1400146484375,1606.8800048828125,9,7,4,4,114,61,31,30,-15.463917525773196,0.5807787421834276,0.46565754325954795,-54,-27,-27,2.95,243,180,233,656,-83.91247524977194
564,2023-03-07,1613.2900390625,1624.780029296875,1612.800048828125,1618.510009765625,24,17,8,6,44,25,13,12,-2.9455081001472756,0.5812455955914575,0.4693918434277601,-8,-5,-3,2.8,359,154,147,660,-82.74297025385107
565,2023-03-08,1606.1300048828125,1615.510009765625,1599.8699951171875,1612.5999755859375,22,15,9,6,67,41,21,20,-6.62739322533137,0.5788381881840502,0.4732403411268363,-26,-12,-14,2.475,196,176,281,653,-83.43595365098304
566,2023-03-09,1615.27001953125,1621.8800048828125,1608.4100341796875,1614.219970703125,34,20,13,10,42,23,15,14,-1.1782032400589102,0.5816743226378315,0.4772894511221131,-3,-2,-1,2.225,251,172,230,653,-83.08754687258028
567,2023-03-10,1605.6199951171875,1609.0999755859375,1596.43994140625,1599.6500244140625,21,12,6,5,87,48,26,24,-9.720176730486008,0.5797268588697156,0.4814715623251194,-36,-20,-16,1.975,116,136,403,655,-84.53492053233401
568,2023-03-13,1592.8199462890625,1602.6500244140625,1572.6500244140625,1573.0699462890625,13,7,4,3,246,159,85,81,-34.31516936671576,0.5791425892067943,0.4858504716481227,-152,-81,-71,1.25,57,76,523,656,-86.99499127358274
569,2023-03-14,1564.9599609375,1572.3599853515625,1518.6600341796875,1523.8900146484375,2,1,1,1,389,266,153,144,-56.995581737849776,0.5769519637403068,0.49030607152195443,-265,-152,-113,0.21666666666666667,39,61,556,656,-89.88267367949572
570,2023-03-15,1544.18994140625,1573.510009765625,1543.6099853515625,1565.0,8,1,1,0,48,35,24,20,-5.891016200294551,0.5736712619859208,0.4947523146706401,-34,-23,-11,0.1,521,66,67,654,-87.27957564004637
571,2023-03-16,1549.760009765625,1558.6700439453125,1538.0999755859375,1554.6500244140625,4,2,2,2,112,80,56,55,-15.905743740795288,0.5728091930204037,0.49934542882826577,-78,-54,-24,-0.19166666666666668,130,141,379,650,-88.60378148762467
572,2023-03-17,1564.5799560546875,1571.5999755859375,1555.239990234375,1563.6700439453125,8,4,2,1,21,15,7,6,-1.914580265095729,0.5752783288228727,0.5040384841969436,-11,-5,-6,-0.2916666666666667,338,140,169,647,-87.50898399023819
573,2023-03-20,1560.22998046875,1569.760009765625,1543.469970703125,1555.449951171875,12,5,4,2,60,44,25,23,-7.069219440353461,0.5757253275457335,0.5088091354478151,-39,-21,-18,-0.48333333333333334,166,136,344,646,-88.64883927622527
574,2023-03-21,1564.3199462890625,1579.68994140625,1561.6500244140625,1577.1800537109375,13,4,0,0,27,19,12,12,-2.0618556701030926,0.5729475497679558,0.5136781663283163,-15,-12,-3,-0.5833333333333334,415,124,107,646,-87.07912592659738
575,2023-03-22,1584.8399658203125,1588.1700439453125,1579.25,1585.0799560546875,14,5,1,1,19,11,8,7,-0.7363770250368189,0.5685494016198075,0.5184275984433852,-6,-7,1,-0.5083333333333333,214,187,243,644,-87.4718794360011
576,2023-03-23,1582.260009765625,1598.5899658203125,1577.699951171875,1593.6500244140625,15,5,2,2,12,10,6,6,0.4418262150220913,0.5605948561652621,0.5228587744681393,-5,-4,-1,-0.425,369,156,123,648,-86.22012906915805
577,2023-03-24,1596.93994140625,1599.780029296875,1588.25,1591.8499755859375,24,9,3,2,12,8,6,5,1.7673048600883652,0.549483745054151,0.5268374697102239,1,-3,4,-0.125,226,171,252,649,-86.60892566211852
578,2023-03-27,1595.1199951171875,1595.8599853515625,1586.010009765625,1593.3699951171875,19,10,6,3,10,5,2,2,1.3254786450662739,0.5491632322336383,0.530622400383544,5,4,1,-0.06666666666666667,243,171,237,651,-86.42215382020912
579,2023-03-28,1600.8199462890625,1607.75,1599.9200439453125,1606.9100341796875,38,13,10,8,6,4,3,3,4.712812960235641,0.5465991296695356,0.5341146457060392,9,7,2,0.025,367,171,112,650,-85.20455037920918
580,2023-03-29,1611.75,1615.2900390625,1602.4300537109375,1610.52001953125,31,9,5,4,7,2,2,2,3.5346097201767304,0.5440594471298531,0.5373374834476514,7,3,4,0.25,229,199,219,647,-84.9809435814592
581,2023-03-30,1611.6400146484375,1613.1600341796875,1601.030029296875,1605.4200439453125,24,7,4,3,14,9,6,5,1.4727540500736378,0.5366910260772215,0.540238318265287,-2,-2,0,0.3333333333333333,146,170,332,648,-86.02388140235055
582,2023-03-31,1607.0,1614.0899658203125,1605.550048828125,1609.1700439453125,22,9,5,5,17,11,9,9,0.7363770250368189,0.5324984794933705,0.5429982343966075,-2,-4,2,0.44166666666666665,198,175,278,651,-86.6980812648138
583,2023-04-03,1610.8399658203125,1613.97998046875,1593.9599609375,1600.3699951171875,33,14,7,7,28,21,16,15,0.7363770250368189,0.5264598321503754,0.5455649138129522,-7,-9,2,0.4666666666666667,237,155,257,649,-87.0561387018335
584,2023-04-04,1601.8900146484375,1603.7900390625,1591.199951171875,1594.050048828125,26,11,7,6,25,18,12,11,0.14727540500736377,0.5206001830275684,0.5479087187353697,-7,-5,-2,0.5583333333333333,161,182,303,646,-87.93702251037638
585,2023-04-05,1593.9200439453125,1594.68994140625,1569.3699951171875,1571.1300048828125,17,7,4,4,69,52,31,28,-7.658321060382916,0.5084023808297661,0.5498327027379663,-45,-27,-18,0.5583333333333333,87,117,445,649,-89.67883142787701
586,2023-04-07,1573.3599853515625,1582.9599609375,1571.260009765625,1577.0699462890625,9,1,1,1,47,33,17,17,-5.596465390279823,0.4926616400890254,0.5512216137888234,-32,-16,-16,0.5666666666666667,239,186,218,643,-89.34372030415737
587,2023-04-10,1577.3900146484375,1596.5400390625,1571.1400146484375,1593.1300048828125,23,7,4,4,28,21,12,11,-0.7363770250368189,0.4801616400890254,0.5521307268598823,-14,-8,-6,0.65,319,167,161,647,-88.37393878728041
588,2023-04-11,1595.77001953125,1598.030029296875,1590.280029296875,1597.0999755859375,21,4,2,2,21,20,13,12,0.0,0.465717195644581,0.552532432523534,-16,-11,-5,0.7166666666666667,248,195,206,649,-87.91102873739413
589,2023-04-12,1597.5899658203125,1598.27001953125,1580.7099609375,1592.6700439453125,28,6,3,3,27,25,13,13,0.14727540500736377,0.4533660051683905,0.5525100310443284,-19,-10,-9,0.5833333333333334,219,200,222,641,-88.03319818175044
590,2023-04-17,1593.0899658203125,1604.2099609375,1587.8699951171875,1600.4100341796875,51,11,7,7,21,15,8,8,4.418262150220913,0.44447711627950165,0.5521311480836413,-4,-1,-3,0.5416666666666666,288,178,175,641,-87.23866377959965
591,2023-04-18,1600.1600341796875,1601.31005859375,1589.5799560546875,1593.8499755859375,37,10,4,4,25,15,10,10,1.7673048600883652,0.43535013215251755,0.5514755048461939,-5,-6,1,0.5666666666666667,219,181,249,649,-87.64466275107023
592,2023-04-19,1588.9000244140625,1595.0799560546875,1579.22998046875,1580.72998046875,29,7,6,5,56,34,19,18,-3.976435935198822,0.42351679881918414,0.5504345080733931,-27,-13,-14,0.44166666666666665,97,147,399,643,-89.07313765128393
593,2023-04-20,1579.97998046875,1582.300048828125,1562.1099853515625,1565.0999755859375,9,4,3,2,107,72,42,38,-14.43298969072165,0.410592822210997,0.5490578299254373,-68,-39,-29,0.19166666666666668,103,135,406,644,-90.56576659930504
594,2023-04-21,1563.9100341796875,1572.4300537109375,1549.6400146484375,1558.3599853515625,17,8,6,6,122,82,47,42,-15.463917525773196,0.39581294799716055,0.5472727835035471,-74,-41,-33,-0.14166666666666666,190,187,269,646,-91.21400480086172
595,2023-04-24,1555.760009765625,1561.550048828125,1553.1500244140625,1557.8699951171875,14,5,2,2,83,46,34,31,-10.1620029455081,0.3836436358278484,0.5451592538365069,-41,-32,-9,-0.2916666666666667,206,167,280,653,-91.87768860394583
596,2023-04-25,1557.800048828125,1559.8599853515625,1538.31005859375,1540.199951171875,17,5,2,2,234,141,92,86,-31.95876288659794,0.3687204679791486,0.5427090417423589,-136,-90,-46,-0.6916666666666667,83,93,478,654,-93.92759778719626
597,2023-04-26,1543.2900390625,1549.81005859375,1532.0799560546875,1543.949951171875,6,2,0,0,195,129,79,75,-27.835051546391753,0.3580061822648629,0.5400683534577344,-127,-79,-48,-1.1166666666666667,247,168,238,653,-93.69682855642704
598,2023-04-27,1539.280029296875,1540.239990234375,1525.9300537109375,1531.22998046875,11,5,3,2,150,107,80,75,-20.471281296023562,0.3457880790829043,0.5371955400915877,-102,-77,-25,-1.3666666666666667,177,142,330,649,-94.73120279717845
599,2023-04-28,1536.280029296875,1542.4100341796875,1524.300048828125,1529.1199951171875,13,5,4,4,66,46,32,30,-7.80559646539028,0.3348194181142434,0.5340998516067322,-41,-28,-13,-1.5166666666666666,265,170,209,644,-94.15893941365916
600,2023-05-02,1531.9200439453125,1535.3499755859375,1517.97998046875,1528.4300537109375,10,1,1,1,194,142,94,88,-27.098674521354933,0.3209597689914363,0.5306627076312985,-141,-93,-48,-1.9166666666666667,133,146,369,648,-95.42599986086393
601,2023-05-03,1521.1700439453125,1533.9000244140625,1507.219970703125,1533.300048828125,19,6,4,2,198,155,122,113,-26.362297496318114,0.30945183248349983,0.5269998140967819,-149,-118,-31,-2.25,295,167,186,648,-94.62051272638595
602,2023-05-08,1541.510009765625,1562.25,1537.4599609375,1562.25,32,14,10,9,34,21,18,18,-0.29455081001472755,0.2987375467692141,0.5229916824670272,-7,-8,1,-2.2666666666666666,444,89,119,652,-92.72022035122072
603,2023-05-09,1561.760009765625,1569.739990234375,1554.6800537109375,1564.6600341796875,46,13,8,8,25,14,11,11,3.0927835051546393,0.2904773128510854,0.5187579173090074,-1,-3,2,-2.3333333333333335,317,150,184,651,-91.78171371726081
604,2023-05-10,1562.6600341796875,1570.8499755859375,1557.6800537109375,1569.56005859375,38,9,6,4,18,12,9,7,2.9455081001472756,0.2815884239621966,0.5142357923626278,-3,-3,0,-2.308333333333333,321,154,174,649,-90.80786203616447
605,2023-05-11,1571.2099609375,1576.5899658203125,1564.780029296875,1567.4000244140625,54,13,6,5,32,23,15,14,3.240058910162003,0.2707947731685457,0.5093228231558388,-10,-9,-1,-2.2666666666666666,201,149,299,649,-91.61615241302994
606,2023-05-12,1565.6600341796875,1567.81005859375,1548.030029296875,1561.3499755859375,36,12,9,7,59,48,34,29,-3.3873343151693667,0.26178314526156904,0.5041034101506001,-36,-25,-11,-2.325,197,138,309,644,-92.51379120212243
607,2023-05-15,1570.6199951171875,1570.6199951171875,1536.8199462890625,1541.3800048828125,45,14,10,9,105,82,56,49,-8.836524300441827,0.25764173112015487,0.49872370373506797,-68,-46,-22,-2.283333333333333,128,122,396,646,-93.98988801081009
608,2023-05-16,1541.1099853515625,1545.739990234375,1536.3599853515625,1539.8399658203125,31,13,9,8,69,55,38,34,-5.596465390279823,0.2497221093707459,0.4930481859598948,-42,-29,-13,-2.25,294,145,208,647,-93.22239788325768
609,2023-05-17,1541.2900390625,1543.6300048828125,1517.2099609375,1522.739990234375,25,9,8,8,79,59,42,38,-7.952871870397644,0.24301377603741256,0.48717405707361044,-50,-34,-16,-2.3583333333333334,112,134,402,648,-94.68805410084356
610,2023-05-18,1531.1500244140625,1541.06005859375,1526.68994140625,1526.68994140625,19,9,7,6,49,37,27,25,-4.418262150220913,0.24422292636420995,0.48137563624832835,-28,-20,-8,-2.3916666666666666,284,164,202,650,-93.98309332394197
611,2023-05-19,1529.1500244140625,1530.469970703125,1512.6600341796875,1514.8900146484375,15,9,4,4,107,82,60,53,-13.549337260677467,0.24459792636420993,0.4756021162166969,-73,-56,-17,-2.4,135,142,373,650,-95.27318466347404
612,2023-05-22,1505.2099609375,1531.010009765625,1491.1199951171875,1529.239990234375,22,12,7,6,191,155,119,109,-24.889543446244478,0.24367200043828402,0.4698394894312529,-143,-112,-31,-2.5416666666666665,258,151,245,654,-94.98073583754125
613,2023-05-23,1526.1500244140625,1536.5899658203125,1518.3800048828125,1534.8399658203125,36,17,14,14,18,9,6,6,2.6509572901325478,0.2553386671049507,0.46431195749675747,8,8,0,-2.3916666666666666,399,134,119,652,-93.54057123789505
614,2023-05-24,1530.6099853515625,1542.9100341796875,1529.449951171875,1536.510009765625,54,18,13,13,7,5,3,3,6.9219440353460975,0.2611880260793097,0.45879711252807387,13,10,3,-2.3,273,160,215,648,-92.94036423426633
615,2023-05-25,1537.550048828125,1541.06005859375,1529.6400146484375,1535.4200439453125,34,15,9,7,13,11,8,8,3.0927835051546393,0.2589004443799633,0.45310235879032723,4,1,3,-2.175,218,183,249,650,-93.35082526879891
616,2023-05-26,1533.1800537109375,1536.0799560546875,1527.5899658203125,1530.8399658203125,30,14,8,7,9,5,4,4,3.0927835051546393,0.2584730939526128,0.4472875399325154,9,4,5,-2.1083333333333334,213,168,272,653,-93.94168263401957
